arsenate->arsenite	('arrA' & 'arrB')	'arsenate->arsenite'	('arrA' & 'arrB')
selenate->selenite_and	('serA' & 'serB' & 'serC')	'selenate->selenite_and'	('serA' & 'serB' & 'serC')
selenate->selenite_or	('serA' | 'serB' | 'serC')	'selenate->selenite_or'	('serA' | 'serB' | 'serC')
iron reduction	('mtrA' | 'mtrB' | 'mtrC' | 'mtrD' | 'mtrE' | 'mtrF' | 'omcA')	'iron reduction'	('mtrA' | 'mtrB' | 'mtrC' | (((((('mtrD')))))) | 'mtrE' | 'mtrF' | 'omcA')
iron oxidation	(('pioA' & 'pioB' & 'pioC') | ('foxE' & 'foxY' & 'foxZ') | 'cyc2')	'iron oxidation'	(('pioA' & 'pioB' & 'pioC') | ('foxE' & 'foxY' & 'foxZ') | 'cyc2')
R5P->RuBP	('prk')	'R5P->RuBP'	('prk')
RuBP+CO2->3PG	('rbcS' | 'rbcL')	'RuBP+CO2->3PG'	('rbcS' | 'rbcL')
PGAP<->3PG	('pgk')	'PGAP<->3PG'	('pgk')
G3P<->PGAP	('gapA.NAD+' | 'gapA.NADP+')	'G3P<->PGAP'	('gapA.NAD+' | 'gapA.NADP+')
G3P+DHAP->FBP	('aldo.classI-1' | 'aldo.classI-2' | 'aldo.classII')	'G3P+DHAP->FBP'	('aldo.classI-1' | 'aldo.classI-2' | 'aldo.classII')
FBP->F6P	('fbpI' | 'fbpII' | 'fbpIII' | 'fbpI-sebp' | 'fbpII-sebp')	'FBP->F6P'	('fbpI' | 'fbpII' | 'fbpIII' | 'fbpI-sebp' | 'fbpII-sebp')
SDP->S7P	('fbpI-sebp' | 'fbpII-sebp')	'SDP->S7P'	('fbpI-sebp' | 'fbpII-sebp')
X5P->R5P	('rpiA' | 'rpiB')	'X5P->R5P'	('rpiA' | 'rpiB')
cc_carboxylation	('RuBP+CO2->3PG')	'cc_carboxylation'	(('rbcS' | 'rbcL'))
cc_reduction	(('PGAP<->3PG') & ('G3P<->PGAP'))	'cc_reduction'	((('pgk')) & (('gapA.NAD+' | 'gapA.NADP+')))
cc_regeneration	(('DHAP<->G3P') & ('G3P+DHAP->FBP') & ('FBP->F6P') & ('SDP->S7P') & ('X5P+E4P<->F6P+G3P') & ('X5P->R5P') & ('R5P->RuBP'))	'cc_regeneration'	((('tpi')) & (('aldo.classI-1' | 'aldo.classI-2' | 'aldo.classII')) & (('fbpI' | 'fbpII' | 'fbpIII' | 'fbpI-sebp' | 'fbpII-sebp')) & (('fbpI-sebp' | 'fbpII-sebp')) & (('tkt')) & (('rpiA' | 'rpiB')) & (('prk')))
cc_full	(('cc_carboxylation') & ('cc_reduction') & ('cc_regeneration'))	'cc_full'	(((('rbcS' | 'rbcL'))) & (((('pgk')) & (('gapA.NAD+' | 'gapA.NADP+')))) & (((('tpi')) & (('aldo.classI-1' | 'aldo.classI-2' | 'aldo.classII')) & (('fbpI' | 'fbpII' | 'fbpIII' | 'fbpI-sebp' | 'fbpII-sebp')) & (('fbpI-sebp' | 'fbpII-sebp')) & (('tkt')) & (('rpiA' | 'rpiB')) & (('prk')))))
cc_key	(('R5P->RuBP') & ('RuBP+CO2->3PG'))	'cc_key'	((('prk')) & (('rbcS' | 'rbcL')))
cc_CO2fixation	('RuBP+CO2->3PG')	'cc_CO2fixation'	(('rbcS' | 'rbcL'))
pyruvate<->acetyl-CoA+CO2_and	('porA' & 'porB' & 'porD' & 'porG')	'pyruvate<->acetyl-CoA+CO2_and'	('porA' & 'porB' & 'porD' & 'porG')
pyruvate<->acetyl-CoA+CO2_or	('porA' | 'porB' | 'porD' | 'porG')	'pyruvate<->acetyl-CoA+CO2_or'	('porA' | 'porB' | 'porD' | 'porG')
citrate->oxaloacetate+acetyl-CoA_and	('aclA' & 'aclB')	'citrate->oxaloacetate+acetyl-CoA_and'	('aclA' & 'aclB')
citrate->oxaloacetate+acetyl-CoA_or	('aclA' | 'aclB')	'citrate->oxaloacetate+acetyl-CoA_or'	('aclA' | 'aclB')
PEP+HCO3->oxaloacetate	('ppc')	'PEP+HCO3->oxaloacetate'	('ppc')
oxaloacetate<->malate	('mdh')	'oxaloacetate<->malate'	('mdh')
malate->fumarate	('fumI' | ('fumalpha' & 'fumbeta') | 'fumII')	'malate->fumarate'	('fumI' | ('fumalpha' & 'fumbeta') | 'fumII')
fumarate->succinate-frdNADH_and	('frd.NADHA' & 'frd.NADHB' & 'frd.NADHC' & 'frd.NADHD' & 'frd.NADHE')	'fumarate->succinate-frdNADH_and'	('frd.NADHA' & 'frd.NADHB' & 'frd.NADHC' & 'frd.NADHD' & 'frd.NADHE')
fumarate->succinate-frdNADH_or	('frd.NADHA' | 'frd.NADHB' | 'frd.NADHC' | 'frd.NADHD' | 'frd.NADHE')	'fumarate->succinate-frdNADH_or'	('frd.NADHA' | 'frd.NADHB' | 'frd.NADHC' | 'frd.NADHD' | 'frd.NADHE')
fumarate->succinate-sdh_and	('sdhA' & 'sdhB' & 'sdhC' & 'sdhD')	'fumarate->succinate-sdh_and'	('sdhA' & 'sdhB' & 'sdhC' & 'sdhD')
fumarate->succinate-sdh_or	('sdhA' | 'sdhB' | 'sdhC' | 'sdhD')	'fumarate->succinate-sdh_or'	('sdhA' | 'sdhB' | 'sdhC' | 'sdhD')
fumarate->succinate-frd_and	('frdA' & 'frdB' & 'frdC' & 'frdD')	'fumarate->succinate-frd_and'	('frdA' & 'frdB' & 'frdC' & 'frdD')
fumarate->succinate-frd_or	('frdA' | 'frdB' | 'frdC' | 'frdD')	'fumarate->succinate-frd_or'	('frdA' | 'frdB' | 'frdC' | 'frdD')
fumarate->succinate-sdhDarch_and	('sdhD_arch1' & 'sdhD_arch2')	'fumarate->succinate-sdhDarch_and'	('sdhD_arch1' & 'sdhD_arch2')
fumarate->succinate-sdhDarch_or	('sdhD_arch1' | 'sdhD_arch2')	'fumarate->succinate-sdhDarch_or'	('sdhD_arch1' | 'sdhD_arch2')
fumarate->succinate	(('fumarate->succinate-frdNADH_and') | ('fumarate->succinate-sdh_and') | ('fumarate->succinate-frd_or') | ('fumarate->succinate-sdhDarch_or'))	'fumarate->succinate'	((('frd.NADHA' & 'frd.NADHB' & 'frd.NADHC' & 'frd.NADHD' & 'frd.NADHE')) | (('sdhA' & 'sdhB' & 'sdhC' & 'sdhD')) | (('frdA' | 'frdB' | 'frdC' | 'frdD')) | (('sdhD_arch1' | 'sdhD_arch2')))
fumarate->succinate-alt	('sdhA' & 'sdhB' & 'sdhC' & ('sdhD' | 'sdhD_arch1' | 'sdhD_arch2'))	'fumarate->succinate-alt'	('sdhA' & 'sdhB' & 'sdhC' & ('sdhD' | 'sdhD_arch1' | 'sdhD_arch2'))
succinate<->succinyl-CoA_and	('sucC' & 'sucD')	'succinate<->succinyl-CoA_and'	('sucC' & 'sucD')
succinate<->succinyl-CoA_or	('sucC' | 'sucD')	'succinate<->succinyl-CoA_or'	('sucC' | 'sucD')
succinyl-CoA+CO2->alpha-ketoglutarate_and	('oforA' & 'oforB' & 'oforC' & 'oforD')	'succinyl-CoA+CO2->alpha-ketoglutarate_and'	('oforA' & 'oforB' & 'oforC' & 'oforD')
succinyl-CoA+CO2->alpha-ketoglutarate_or	('oforA' | 'oforB' | 'oforC' | 'oforD')	'succinyl-CoA+CO2->alpha-ketoglutarate_or'	('oforA' | 'oforB' | 'oforC' | 'oforD')
alpha-ketoglutarate+CO2->isocitrate	('icd')	'alpha-ketoglutarate+CO2->isocitrate'	('icd')
isocitrate<->citrate	('acnA' | 'acnB')	'isocitrate<->citrate'	('acnA' | 'acnB')
rca_full	(('pyruvate->PEP-ppdk') & ('pyruvate<->acetyl-CoA+CO2_or') & ('citrate->oxaloacetate+acetyl-CoA_or') & ('PEP+HCO3->oxaloacetate') & ('oxaloacetate<->malate') & ('malate->fumarate') & ('fumarate->succinate') & ('succinate<->succinyl-CoA_or') & ('succinyl-CoA+CO2->alpha-ketoglutarate_or') & ('alpha-ketoglutarate+CO2->isocitrate') & ('isocitrate<->citrate'))	'rca_full'	((('ppdK')) & (('porA' | 'porB' | 'porD' | 'porG')) & (('aclA' | 'aclB')) & (('ppc')) & (('mdh')) & (('fumI' | ('fumalpha' & 'fumbeta') | 'fumII')) & (((('frd.NADHA' & 'frd.NADHB' & 'frd.NADHC' & 'frd.NADHD' & 'frd.NADHE')) | (('sdhA' & 'sdhB' & 'sdhC' & 'sdhD')) | (('frdA' | 'frdB' | 'frdC' | 'frdD')) | (('sdhD_arch1' | 'sdhD_arch2')))) & (('sucC' | 'sucD')) & (('oforA' | 'oforB' | 'oforC' | 'oforD')) & (('icd')) & (('acnA' | 'acnB')))
rca_key1	('citrate->oxaloacetate+acetyl-CoA_or')	'rca_key1'	(('aclA' | 'aclB'))
rca_key2	(('succinyl-CoA+CO2->alpha-ketoglutarate_or') & ('citrate->oxaloacetate+acetyl-CoA_or'))	'rca_key2'	((('oforA' | 'oforB' | 'oforC' | 'oforD')) & (('aclA' | 'aclB')))
rca_CO2fixation	(('PEP+HCO3->oxaloacetate') | ('pyruvate<->acetyl-CoA+CO2_or') | ('succinyl-CoA+CO2->alpha-ketoglutarate_or') | ('succinate<->succinyl-CoA_or'))	'rca_CO2fixation'	((('ppc')) | (('porA' | 'porB' | 'porD' | 'porG')) | (('oforA' | 'oforB' | 'oforC' | 'oforD')) | (('sucC' | 'sucD')))
malate->malyl-CoA_and	('smtA' & 'smtB')	'malate->malyl-CoA_and'	('smtA' & 'smtB')
malate->malyl-CoA_or	('smtA' | 'smtB')	'malate->malyl-CoA_or'	('smtA' | 'smtB')
malyl-CoA->glyoxylate+acetyl-CoA	('mcl')	'malyl-CoA->glyoxylate+acetyl-CoA'	('mcl')
acetyl-CoA+HCO3->malonyl-CoA	('bccP' | 'accC' | 'accA' | 'accD' | 'pcc1' | 'pcc2' | 'pcc3' | 'pcc4' | 'pcc5' | 'pcc6')	'acetyl-CoA+HCO3->malonyl-CoA'	('bccP' | 'accC' | 'accA' | 'accD' | 'pcc1' | 'pcc2' | 'pcc3' | 'pcc4' | 'pcc5' | 'pcc6')
malonyl-CoA->malonate semialdehyde	('mcr' | 'asd1')	'malonyl-CoA->malonate semialdehyde'	('mcr' | 'asd1')
malonate semialdehyde->3-hydroxypropanoate	('mcr' | 'hpd')	'malonate semialdehyde->3-hydroxypropanoate'	('mcr' | 'hpd')
3-hydroxypropanoate->3-hydroxypropanoyl-CoA	('hys' | 'acr-hydt')	'3-hydroxypropanoate->3-hydroxypropanoyl-CoA'	('hys' | 'acr-hydt')
3-hydroxypropanoyl-CoA->acryloyl-CoA	('hydt' | 'acr-hydt')	'3-hydroxypropanoyl-CoA->acryloyl-CoA'	('hydt' | 'acr-hydt')
acryloyl-CoA->propionyl-CoA	('acr' | 'acr-hydt')	'acryloyl-CoA->propionyl-CoA'	('acr' | 'acr-hydt')
propionyl-CoA+HCO3->S-methylmalonyl-CoA	('bccP' | 'accC' | 'accA' | 'accD' | 'pcc1' | 'pcc2' | 'pcc3' | 'pcc4' | 'pcc5')	'propionyl-CoA+HCO3->S-methylmalonyl-CoA'	('bccP' | 'accC' | 'accA' | 'accD' | 'pcc1' | 'pcc2' | 'pcc3' | 'pcc4' | 'pcc5')
S-methylmalonyl-CoA<->R-methylmalonyl-CoA	('epi')	'S-methylmalonyl-CoA<->R-methylmalonyl-CoA'	('epi')
R-methylmalonyl-CoA<->succinyl-CoA	('mut')	'R-methylmalonyl-CoA<->succinyl-CoA'	('mut')
succinate->fumarate_full	(('sdhA' & 'sdhB' & 'sdhC' & 'sdhD') | ('frdA' & 'frdB' & 'frdC' & 'frdD') | ('sdhD_arch1' & 'sdhD_arch2'))	'succinate->fumarate_full'	(('sdhA' & 'sdhB' & 'sdhC' & 'sdhD') | ('frdA' & 'frdB' & 'frdC' & 'frdD') | ('sdhD_arch1' & 'sdhD_arch2'))
succinate->fumarate_key	(('sdhA' & 'sdhB' & 'sdhC') | ('frdA' & 'frdB' & 'frdC'))	'succinate->fumarate_key'	(('sdhA' & 'sdhB' & 'sdhC') | ('frdA' & 'frdB' & 'frdC'))
fumarate->malate_full	('fumI' | ('fumalpha' & 'fumbeta') | 'fumII')	'fumarate->malate_full'	('fumI' | ('fumalpha' & 'fumbeta') | 'fumII')
propionyl-CoA+glyoxylate->beta-methylmalyl-CoA	('mcl')	'propionyl-CoA+glyoxylate->beta-methylmalyl-CoA'	('mcl')
beta-methylmalyl-CoA->3-methylfumaroyl-CoA	('mfch')	'beta-methylmalyl-CoA->3-methylfumaroyl-CoA'	('mfch')
3-methylfumaroyl-CoA->3-methylfumaryl-CoA	('mct')	'3-methylfumaroyl-CoA->3-methylfumaryl-CoA'	('mct')
3-methylfumaryl-CoA->3S-citramalyl-CoA	('meh')	'3-methylfumaryl-CoA->3S-citramalyl-CoA'	('meh')
3S-citramalyl-CoA->acetyl-CoA+pyruvate	('mcl')	'3S-citramalyl-CoA->acetyl-CoA+pyruvate'	('mcl')
acetyl-CoA->propionyl-CoA	(('acetyl-CoA+HCO3->malonyl-CoA') & ('malonyl-CoA->malonate semialdehyde') & ('malonate semialdehyde->3-hydroxypropanoate') & ('3-hydroxypropanoate->3-hydroxypropanoyl-CoA') & ('3-hydroxypropanoyl-CoA->acryloyl-CoA') & ('acryloyl-CoA->propionyl-CoA'))	'acetyl-CoA->propionyl-CoA'	((('bccP' | 'accC' | 'accA' | 'accD' | 'pcc1' | 'pcc2' | 'pcc3' | 'pcc4' | 'pcc5' | 'pcc6')) & (('mcr' | 'asd1')) & (('mcr' | 'hpd')) & (('hys' | 'acr-hydt')) & (('hydt' | 'acr-hydt')) & (('acr' | 'acr-hydt')))
propionyl-CoA->acetyl-CoA_CO2fixation	(('propionyl-CoA+HCO3->S-methylmalonyl-CoA') & ('S-methylmalonyl-CoA<->R-methylmalonyl-CoA') & ('R-methylmalonyl-CoA<->succinyl-CoA') & ('malate->malyl-CoA_or') & ('succinate->fumarate_key') & ('fumarate->malate_full') & ('malyl-CoA->glyoxylate+acetyl-CoA'))	'propionyl-CoA->acetyl-CoA_CO2fixation'	((('bccP' | 'accC' | 'accA' | 'accD' | 'pcc1' | 'pcc2' | 'pcc3' | 'pcc4' | 'pcc5')) & (('epi')) & (('mut')) & (('smtA' | 'smtB')) & ((('sdhA' & 'sdhB' & 'sdhC') | ('frdA' & 'frdB' & 'frdC'))) & (('fumI' | ('fumalpha' & 'fumbeta') | 'fumII')) & (('mcl')))
propionyl-CoA->acetyl-CoA_glyoxylateassim	(('propionyl-CoA+glyoxylate->beta-methylmalyl-CoA') & ('beta-methylmalyl-CoA->3-methylfumaroyl-CoA') & ('3-methylfumaroyl-CoA->3-methylfumaryl-CoA') & ('3-methylfumaryl-CoA->3S-citramalyl-CoA') & ('3S-citramalyl-CoA->acetyl-CoA+pyruvate'))	'propionyl-CoA->acetyl-CoA_glyoxylateassim'	((('mcl')) & (('mfch')) & (('mct')) & (('meh')) & (('mcl')))
3hpb1_full	(('acetyl-CoA->propionyl-CoA') & ('propionyl-CoA->acetyl-CoA_CO2fixation') & ('propionyl-CoA->acetyl-CoA_glyoxylateassim'))	'3hpb1_full'	((((('bccP' | 'accC' | 'accA' | 'accD' | 'pcc1' | 'pcc2' | 'pcc3' | 'pcc4' | 'pcc5' | 'pcc6')) & (('mcr' | 'asd1')) & (('mcr' | 'hpd')) & (('hys' | 'acr-hydt')) & (('hydt' | 'acr-hydt')) & (('acr' | 'acr-hydt')))) & (((('bccP' | 'accC' | 'accA' | 'accD' | 'pcc1' | 'pcc2' | 'pcc3' | 'pcc4' | 'pcc5')) & (('epi')) & (('mut')) & (('smtA' | 'smtB')) & ((('sdhA' & 'sdhB' & 'sdhC') | ('frdA' & 'frdB' & 'frdC'))) & (('fumI' | ('fumalpha' & 'fumbeta') | 'fumII')) & (('mcl')))) & (((('mcl')) & (('mfch')) & (('mct')) & (('meh')) & (('mcl')))))
3hpb1_CO2fixation	(('propionyl-CoA+HCO3->S-methylmalonyl-CoA') & ('acetyl-CoA+HCO3->malonyl-CoA'))	'3hpb1_CO2fixation'	((('bccP' | 'accC' | 'accA' | 'accD' | 'pcc1' | 'pcc2' | 'pcc3' | 'pcc4' | 'pcc5')) & (('bccP' | 'accC' | 'accA' | 'accD' | 'pcc1' | 'pcc2' | 'pcc3' | 'pcc4' | 'pcc5' | 'pcc6')))
3hpb1_key1	(('malonyl-CoA->malonate semialdehyde') & ('acryloyl-CoA->propionyl-CoA'))	'3hpb1_key1'	((('mcr' | 'asd1')) & (('acr' | 'acr-hydt')))
3hpb1_key2	(('malonyl-CoA->malonate semialdehyde') & ('propionyl-CoA+glyoxylate->beta-methylmalyl-CoA'))	'3hpb1_key2'	((('mcr' | 'asd1')) & (('mcl')))
CO->CO2	('cdhA' | 'cdhB' | 'cooF' | 'cooS')	'CO->CO2'	('cdhA' | 'cdhB' | 'cooF' | 'cooS')
CO2->formate_and	('fdh.NADP+A' & 'fdh.NADP+B')	'CO2->formate_and'	('fdh.NADP+A' & 'fdh.NADP+B')
CO2->formate_or	('fdh.NADP+A' | 'fdh.NADP+B')	'CO2->formate_or'	('fdh.NADP+A' | 'fdh.NADP+B')
formate->formyl-THF	('ftfL')	'formate->formyl-THF'	('ftfL')
formyl-THF->methenyl-THF	('folD')	'formyl-THF->methenyl-THF'	('folD')
methenyl-THF->methylene-THF	('formyl-THF->methenyl-THF')	'methenyl-THF->methylene-THF'	(('folD'))
methylene-THF->methyl-THF	('metF')	'methylene-THF->methyl-THF'	('metF')
methyl-THF->methyl-CoFeSP	('acsE')	'methyl-THF->methyl-CoFeSP'	('acsE')
methyl-CoFeSP+CO->acetyl-CoA	('acsB' | ('acsC' & 'acsD'))	'methyl-CoFeSP+CO->acetyl-CoA'	('acsB' | ('acsC' & 'acsD'))
acetyl-CoA->acetyl-P	('pta1' | 'pta2' | 'pta3')	'acetyl-CoA->acetyl-P'	('pta1' | 'pta2' | 'pta3')
acetyl-P<->acetate	('ackA')	'acetyl-P<->acetate'	('ackA')
CO2->CO	('cooF' | 'cooS')	'CO2->CO'	('cooF' | 'cooS')
rac_full	(('CO->CO2') & ('CO2->formate_or') & ('formate->formyl-THF') & ('formyl-THF->methenyl-THF') & ('methylene-THF->methyl-THF') & ('methyl-THF->methyl-CoFeSP') & ('methyl-CoFeSP+CO->acetyl-CoA') & ('CO2->CO') & ('acetyl-CoA->acetyl-P') & ('acetyl-P<->acetate'))	'rac_full'	((('cdhA' | 'cdhB' | 'cooF' | 'cooS')) & (('fdh.NADP+A' | 'fdh.NADP+B')) & (('ftfL')) & (('folD')) & (('metF')) & (('acsE')) & (('acsB' | ('acsC' & 'acsD'))) & (('cooF' | 'cooS')) & (('pta1' | 'pta2' | 'pta3')) & (('ackA')))
rac_CO2fixation	('methyl-CoFeSP+CO->acetyl-CoA')	'rac_CO2fixation'	(('acsB' | ('acsC' & 'acsD')))
rac_key1	(('CO2->formate_or') & ('CO2->CO'))	'rac_key1'	((('fdh.NADP+A' | 'fdh.NADP+B')) & (('cooF' | 'cooS')))
rac_key2	(('methyl-CoFeSP+CO->acetyl-CoA') & ('CO2->CO'))	'rac_key2'	((('acsB' | ('acsC' & 'acsD'))) & (('cooF' | 'cooS')))
succinyl-CoA->succinate semialdehyde	('asd1' | 'asd2')	'succinyl-CoA->succinate semialdehyde'	('asd1' | 'asd2')
succinate semialdehyde->4-hydroxybutyrate	('ssadh')	'succinate semialdehyde->4-hydroxybutyrate'	('ssadh')
4-hydroxybutyrate->4-hydroxybutyryl-CoA	('4hbl1' & '4hbl2' & '4hbl3')	'4-hydroxybutyrate->4-hydroxybutyryl-CoA'	('4hbl1' & '4hbl2' & '4hbl3')
4-hydroxybutyryl-CoA->crotonoyl-CoA	('abfD')	'4-hydroxybutyryl-CoA->crotonoyl-CoA'	('abfD')
crotonoyl-CoA->3-hydroxybutyryl-CoA	('cch-hbcd')	'crotonoyl-CoA->3-hydroxybutyryl-CoA'	('cch-hbcd')
3-hydroxybutyryl-CoA->acetoacetyl-CoA	('cch-hbcd')	'3-hydroxybutyryl-CoA->acetoacetyl-CoA'	('cch-hbcd')
acetoacetyl-CoA->acetyl-CoA	('atoB')	'acetoacetyl-CoA->acetyl-CoA'	('atoB')
propionyl-CoA->acetyl-CoA-3hp4hb	(('propionyl-CoA+HCO3->S-methylmalonyl-CoA') & ('S-methylmalonyl-CoA<->R-methylmalonyl-CoA') & ('R-methylmalonyl-CoA<->succinyl-CoA') & ('succinyl-CoA->succinate semialdehyde') & ('succinate semialdehyde->4-hydroxybutyrate') & ('4-hydroxybutyrate->4-hydroxybutyryl-CoA') & ('4-hydroxybutyryl-CoA->crotonoyl-CoA') & ('crotonoyl-CoA->3-hydroxybutyryl-CoA') & ('3-hydroxybutyryl-CoA->acetoacetyl-CoA') & ('acetoacetyl-CoA->acetyl-CoA'))	'propionyl-CoA->acetyl-CoA-3hp4hb'	((('bccP' | 'accC' | 'accA' | 'accD' | 'pcc1' | 'pcc2' | 'pcc3' | 'pcc4' | 'pcc5')) & (('epi')) & (('mut')) & (('asd1' | 'asd2')) & (('ssadh')) & (('4hbl1' & '4hbl2' & '4hbl3')) & (('abfD')) & (('cch-hbcd')) & (('cch-hbcd')) & (('atoB')))
3hp4hb_full	(('propionyl-CoA->acetyl-CoA-3hp4hb') & ('acetyl-CoA->propionyl-CoA'))	'3hp4hb_full'	((((('bccP' | 'accC' | 'accA' | 'accD' | 'pcc1' | 'pcc2' | 'pcc3' | 'pcc4' | 'pcc5')) & (('epi')) & (('mut')) & (('asd1' | 'asd2')) & (('ssadh')) & (('4hbl1' & '4hbl2' & '4hbl3')) & (('abfD')) & (('cch-hbcd')) & (('cch-hbcd')) & (('atoB')))) & (((('bccP' | 'accC' | 'accA' | 'accD' | 'pcc1' | 'pcc2' | 'pcc3' | 'pcc4' | 'pcc5' | 'pcc6')) & (('mcr' | 'asd1')) & (('mcr' | 'hpd')) & (('hys' | 'acr-hydt')) & (('hydt' | 'acr-hydt')) & (('acr' | 'acr-hydt')))))
3hp4hb_key1	((('4-hydroxybutyryl-CoA->crotonoyl-CoA') & ('crotonoyl-CoA->3-hydroxybutyryl-CoA') & ('3-hydroxybutyryl-CoA->acetoacetyl-CoA') & ('acetoacetyl-CoA->acetyl-CoA')) | (('succinyl-CoA->succinate semialdehyde') & ('succinate semialdehyde->4-hydroxybutyrate') & ('acetyl-CoA+HCO3->malonyl-CoA') & ('acryloyl-CoA->propionyl-CoA')))	'3hp4hb_key1'	(((('abfD')) & (('cch-hbcd')) & (('cch-hbcd')) & (('atoB'))) | ((('asd1' | 'asd2')) & (('ssadh')) & (('bccP' | 'accC' | 'accA' | 'accD' | 'pcc1' | 'pcc2' | 'pcc3' | 'pcc4' | 'pcc5' | 'pcc6')) & (('acr' | 'acr-hydt'))))
3hp4hb_key2	(('propionyl-CoA+HCO3->S-methylmalonyl-CoA') & ('malonyl-CoA->malonate semialdehyde') & ('malonate semialdehyde->3-hydroxypropanoate') & ('3-hydroxypropanoate->3-hydroxypropanoyl-CoA') & ('3-hydroxypropanoyl-CoA->acryloyl-CoA') & ('acryloyl-CoA->propionyl-CoA') & ('R-methylmalonyl-CoA<->succinyl-CoA') & ('4-hydroxybutyryl-CoA->crotonoyl-CoA'))	'3hp4hb_key2'	((('bccP' | 'accC' | 'accA' | 'accD' | 'pcc1' | 'pcc2' | 'pcc3' | 'pcc4' | 'pcc5')) & (('mcr' | 'asd1')) & (('mcr' | 'hpd')) & (('hys' | 'acr-hydt')) & (('hydt' | 'acr-hydt')) & (('acr' | 'acr-hydt')) & (('mut')) & (('abfD')))
3hp4hb_CO2fixation	(('propionyl-CoA+HCO3->S-methylmalonyl-CoA') & ('acetyl-CoA+HCO3->malonyl-CoA'))	'3hp4hb_CO2fixation'	((('bccP' | 'accC' | 'accA' | 'accD' | 'pcc1' | 'pcc2' | 'pcc3' | 'pcc4' | 'pcc5')) & (('bccP' | 'accC' | 'accA' | 'accD' | 'pcc1' | 'pcc2' | 'pcc3' | 'pcc4' | 'pcc5' | 'pcc6')))
pyruvate->PEP-pps	('pps')	'pyruvate->PEP-pps'	('pps')
dicarb-4hb_full	(('succinate semialdehyde->4-hydroxybutyrate') & ('4-hydroxybutyrate->4-hydroxybutyryl-CoA') & ('4-hydroxybutyryl-CoA->crotonoyl-CoA') & ('crotonoyl-CoA->3-hydroxybutyryl-CoA') & ('3-hydroxybutyryl-CoA->acetoacetyl-CoA') & ('acetoacetyl-CoA->acetyl-CoA') & ('pyruvate<->acetyl-CoA+CO2_or') & ('pyruvate->PEP-pps') & ('PEP+HCO3->oxaloacetate') & ('oxaloacetate<->malate') & ('malate->fumarate') & ('fumarate->succinate-alt') & ('succinate<->succinyl-CoA_or') & ('succinyl-CoA->succinate semialdehyde'))	'dicarb-4hb_full'	((('ssadh')) & (('4hbl1' & '4hbl2' & '4hbl3')) & (('abfD')) & (('cch-hbcd')) & (('cch-hbcd')) & (('atoB')) & (('porA' | 'porB' | 'porD' | 'porG')) & (('pps')) & (('ppc')) & (('mdh')) & (('fumI' | ('fumalpha' & 'fumbeta') | 'fumII')) & (('sdhA' & 'sdhB' & 'sdhC' & ('sdhD' | 'sdhD_arch1' | 'sdhD_arch2'))) & (('sucC' | 'sucD')) & (('asd1' | 'asd2')))
dicarb-4hb_CO2fixation	(('pyruvate<->acetyl-CoA+CO2_or') & ('PEP+HCO3->oxaloacetate'))	'dicarb-4hb_CO2fixation'	((('porA' | 'porB' | 'porD' | 'porG')) & (('ppc')))
dicarb-4hb_key	('4-hydroxybutyryl-CoA->crotonoyl-CoA')	'dicarb-4hb_key'	(('abfD'))
dicarb-4hb_keyandCO2fixation	(('dicarb-4hb_CO2fixation') & ('dicarb-4hb_key'))	'dicarb-4hb_keyandCO2fixation'	((((('porA' | 'porB' | 'porD' | 'porG')) & (('ppc')))) & ((('abfD'))))
co2fix	('cc_key') | ('3hpb1_key1') | ('3hp4hb_key1') | ('dicarb-4hb_CO2fixation') | ('rac_key1') | ('rca_key1')	'co2fix'	(((('prk')) & (('rbcS' | 'rbcL')))) | (((('mcr' | 'asd1')) & (('acr' | 'acr-hydt')))) | ((((('abfD')) & (('cch-hbcd')) & (('cch-hbcd')) & (('atoB'))) | ((('asd1' | 'asd2')) & (('ssadh')) & (('bccP' | 'accC' | 'accA' | 'accD' | 'pcc1' | 'pcc2' | 'pcc3' | 'pcc4' | 'pcc5' | 'pcc6')) & (('acr' | 'acr-hydt'))))) | (((('porA' | 'porB' | 'porD' | 'porG')) & (('ppc')))) | (((('fdh.NADP+A' | 'fdh.NADP+B')) & (('cooF' | 'cooS')))) | ((('aclA' | 'aclB')))
ethanolamine-utilization_and	('eutK' & 'eutL' & 'eutM' & 'eutN' & 'eutS')	'ethanolamine-utilization_and'	('eutK' & 'eutL' & 'eutM' & 'eutN' & 'eutS')
ethanolamine-utilization_or	('eutK' | 'eutL' | 'eutM' | 'eutN' | 'eutS')	'ethanolamine-utilization_or'	('eutK' | 'eutL' | 'eutM' | 'eutN' | 'eutS')
CO2concentratingmechanism_and	('ccmK' & 'ccmL' & 'ccmM' & 'ccmN' & 'ccmO')	'CO2concentratingmechanism_and'	('ccmK' & 'ccmL' & 'ccmM' & 'ccmN' & 'ccmO')
CO2concentratingmechanism_or	('ccmK' | 'ccmL' | 'ccmM' | 'ccmN' | 'ccmO')	'CO2concentratingmechanism_or'	('ccmK' | 'ccmL' | 'ccmM' | 'ccmN' | 'ccmO')
carboxysome	('ethanolamine-utilization_and' | 'CO2concentratingmechanism_or')	'carboxysome'	(('eutK' & 'eutL' & 'eutM' & 'eutN' & 'eutS') | ('ccmK' | 'ccmL' | 'ccmM' | 'ccmN' | 'ccmO'))
citrate->oxaloacetate_and	('citD' & 'citE' & 'citF')	'citrate->oxaloacetate_and'	('citD' & 'citE' & 'citF')
citrate->oxaloacetate_or	('citD' | 'citE' | 'citF')	'citrate->oxaloacetate_or'	('citD' | 'citE' | 'citF')
pyruvate+HCO3->oxaloacetate	('pyc' & 'pycA' & 'pycB')	'pyruvate+HCO3->oxaloacetate'	('pyc' & 'pycA' & 'pycB')
pyruvate->acetyl-CoA+formate	('pflD')	'pyruvate->acetyl-CoA+formate'	('pflD')
acetyl-CoA->acetoacetyl-CoA	('atoB')	'acetyl-CoA->acetoacetyl-CoA'	('atoB')
acetoacetyl-CoA->3-hydroxybutyryl-CoA-NADP+	('hbd')	'acetoacetyl-CoA->3-hydroxybutyryl-CoA-NADP+'	('hbd')
acetoacetyl-CoA->3-hydroxybutyryl-CoA-NAD+	('cch-hbcd')	'acetoacetyl-CoA->3-hydroxybutyryl-CoA-NAD+'	('cch-hbcd')
3-hydroxybutyryl-CoA->crotonoyl-CoA	('crt' | 'echA' | 'fadB' | 'fadJ')	'3-hydroxybutyryl-CoA->crotonoyl-CoA'	('crt' | 'echA' | 'fadB' | 'fadJ')
crotonoyl-CoA->butyryl-Coa	('bcd')	'crotonoyl-CoA->butyryl-Coa'	('bcd')
acetoacetyl-CoA->butyryl-CoA	(('acetoacetyl-CoA->3-hydroxybutyryl-CoA-NADP+') & ('3-hydroxybutyryl-CoA->crotonoyl-CoA') & ('crotonoyl-CoA->butyryl-Coa'))	'acetoacetyl-CoA->butyryl-CoA'	((('hbd')) & (('crt' | 'echA' | 'fadB' | 'fadJ')) & (('bcd')))
butyryl-CoA->butanoyl phosphate	('ptb')	'butyryl-CoA->butanoyl phosphate'	('ptb')
butanoyl phosphate->butanoate	('buk')	'butanoyl phosphate->butanoate'	('buk')
pyruvate->butanoate	(('pyruvate->acetyl-CoA+formate') & ('butanoyl phosphate->butanoate'))	'pyruvate->butanoate'	((('pflD')) & (('buk')))
butyryl-CoA->butanoate	(('butyryl-CoA->butanoyl phosphate') & ('butanoyl phosphate->butanoate'))	'butyryl-CoA->butanoate'	((('ptb')) & (('buk')))
pyruvate->butanol	(('pyruvate->acetyl-CoA+formate') & ('butyraldehyde->butanol'))	'pyruvate->butanol'	((('pflD')) & (('bdhAB')))
butyraldehyde->butanol	('bdhAB')	'butyraldehyde->butanol'	('bdhAB')
acetoacetyl-CoA->butanoate	(('acetoacetyl-CoA->butyryl-CoA') & ('butyryl-CoA->butanoate'))	'acetoacetyl-CoA->butanoate'	((((('hbd')) & (('crt' | 'echA' | 'fadB' | 'fadJ')) & (('bcd')))) & (((('ptb')) & (('buk')))))
acetoacetyl-CoA->butanol	(('acetoacetyl-CoA->butyryl-CoA') & ('butyraldehyde->butanol'))	'acetoacetyl-CoA->butanol'	((((('hbd')) & (('crt' | 'echA' | 'fadB' | 'fadJ')) & (('bcd')))) & (('bdhAB')))
acetoacetyl-CoA->acetoacetate	('atoA' | 'atoD' | 'ydiF')	'acetoacetyl-CoA->acetoacetate'	('atoA' | 'atoD' | 'ydiF')
acetoacetate->acetone	('adc')	'acetoacetate->acetone'	('adc')
acetone->isopropanol	('isopadh')	'acetone->isopropanol'	('isopadh')
acetoacetyl-CoA->acetone	(('acetoacetyl-CoA->acetoacetate') & ('acetoacetate->acetone'))	'acetoacetyl-CoA->acetone'	((('atoA' | 'atoD' | 'ydiF')) & (('adc')))
acetoacetyl-CoA->isopropanol	(('acetoacetyl-CoA->acetoacetate') & ('acetoacetate->acetone') & ('acetone->isopropanol'))	'acetoacetyl-CoA->isopropanol'	((('atoA' | 'atoD' | 'ydiF')) & (('adc')) & (('isopadh')))
pyruvate->acetolactate	('aclSlarge' | 'aclSsmall_1' | 'aclSsmall_2')	'pyruvate->acetolactate'	('aclSlarge' | 'aclSsmall_1' | 'aclSsmall_2')
acetolactate->acetoin	('alsD')	'acetolactate->acetoin'	('alsD')
acetoin->butyleneglycol	('butB')	'acetoin->butyleneglycol'	('butB')
pyruvate->butyleneglycol	(('pyruvate->acetolactate') & ('acetolactate->acetoin') & ('acetoin->butyleneglycol'))	'pyruvate->butyleneglycol'	((('aclSlarge' | 'aclSsmall_1' | 'aclSsmall_2')) & (('alsD')) & (('butB')))
acetate->acetaldehyde	('aldh')	'acetate->acetaldehyde'	('aldh')
acetaldehyde->ethanol	('adh' | 'adhP' | 'adhE' | 'exaA' | 'yiaY')	'acetaldehyde->ethanol'	('adh' | 'adhP' | 'adhE' | 'exaA' | 'yiaY')
acetyl-CoA->acetaldehyde	('adhE')	'acetyl-CoA->acetaldehyde'	('adhE')
pyruvate->acetaldehyde	('pdc')	'pyruvate->acetaldehyde'	('pdc')
pyruvate->ethanol	(('pyruvate->acetaldehyde') & ('acetaldehyde->ethanol'))	'pyruvate->ethanol'	((('pdc')) & (('adh' | 'adhP' | 'adhE' | 'exaA' | 'yiaY')))
pyruvate->lactate	('ldh')	'pyruvate->lactate'	('ldh')
xylulose 5-phosphate->acetyl-P+G3P	('xpk')	'xylulose 5-phosphate->acetyl-P+G3P'	('xpk')
propanoyl phosphate->propionate	('tdcD' | 'pduW')	'propanoyl phosphate->propionate'	('tdcD' | 'pduW')
propionate fermentation_succinatepathway	(('R-methylmalonyl-CoA<->succinyl-CoA') & ('S-methylmalonyl-CoA<->R-methylmalonyl-CoA') & ('propanoyl phosphate->propionate'))	'propionate fermentation_succinatepathway'	((('mut')) & (('epi')) & (('tdcD' | 'pduW')))
3PG->2PG	('gpmA' | 'gpmB' | 'gpmI' | 'apgM')	'3PG->2PG'	('gpmA' | 'gpmB' | 'gpmI' | 'apgM')
2PG->PEP	('eno')	'2PG->PEP'	('eno')
pyruvate->acetate	(('poxB') | ('acetyl-CoA->acetate'))	'pyruvate->acetate'	(('poxB') | (((('pta1' | 'pta2' | 'pta3')) & (('ackA')))))
pyruvate->propionate+acetate+CO2	('pct')	'pyruvate->propionate+acetate+CO2'	('pct')
pyruvate->propanoate	('scpC')	'pyruvate->propanoate'	('scpC')
acetylene->acetaldehyde	('ahy')	'acetylene->acetaldehyde'	('ahy')
acetaldehyde->acetyl-CoA	('aldh')	'acetaldehyde->acetyl-CoA'	('aldh')
acetylene->acetate	(('acetylene->acetaldehyde') & ('acetaldehyde->acetyl-CoA') & ('acetyl-CoA->acetyl-P') & ('acetyl-P<->acetate'))	'acetylene->acetate'	((('ahy')) & (('aldh')) & (('pta1' | 'pta2' | 'pta3')) & (('ackA')))
acetylene->ethanol	(('acetylene->acetaldehyde') & ('acetaldehyde->ethanol'))	'acetylene->ethanol'	((('ahy')) & (('adh' | 'adhP' | 'adhE' | 'exaA' | 'yiaY')))
acetylene->acetate+ethanol	(('acetylene->acetate') & ('acetylene->ethanol'))	'acetylene->acetate+ethanol'	((((('ahy')) & (('aldh')) & (('pta1' | 'pta2' | 'pta3')) & (('ackA')))) & (((('ahy')) & (('adh' | 'adhP' | 'adhE' | 'exaA' | 'yiaY')))))
resorcinol->hydroxyhydroquinone	('graA')	'resorcinol->hydroxyhydroquinone'	('graA')
resorcinol degradation	('resorcinol->hydroxyhydroquinone')	'resorcinol degradation'	(('graA'))
glycerol->DHA	('gldA')	'glycerol->DHA'	('gldA')
DHA->DHAP	('dak')	'DHA->DHAP'	('dak')
glycerol->3-hydroxypropanal_and	('dhbE' & 'dhaC' & 'dhaB')	'glycerol->3-hydroxypropanal_and'	('dhbE' & 'dhaC' & 'dhaB')
glycerol->3-hydroxypropanal_or	('dhbE' | 'dhaC' | 'dhaB')	'glycerol->3-hydroxypropanal_or'	('dhbE' | 'dhaC' | 'dhaB')
3-hydroxypropanal->1,3-PDO	('dhaT')	'3-hydroxypropanal->1,3-PDO'	('dhaT')
glycerol->1,3-PDO	('glycerol->3-hydroxypropanal_or' & '3-hydroxypropanal->1,3-PDO')	'glycerol->1,3-PDO'	(('dhbE' | 'dhaC' | 'dhaB') & ('dhaT'))
glycerol degradation	(('glycerol->DHA') | ('glycerol->3-hydroxypropanal_or'))	'glycerol degradation'	((('gldA')) | (('dhbE' | 'dhaC' | 'dhaB')))
galacturonate->tagaturonate	('uxaC')	'galacturonate->tagaturonate'	('uxaC')
tagaturonate->altronate	('uxaB')	'tagaturonate->altronate'	('uxaB')
altronate->2Keto3deoxyDgluconate	('uxaA')	'altronate->2Keto3deoxyDgluconate'	('uxaA')
galacturonate degradation	(('galacturonate->tagaturonate') & ('tagaturonate->altronate') & ('altronate->2Keto3deoxyDgluconate'))	'galacturonate degradation'	((('uxaC')) & (('uxaB')) & (('uxaA')))
galactose->alphagalactose	('galM')	'galactose->alphagalactose'	('galM')
alphagalactose->galactose1P	('galK')	'alphagalactose->galactose1P'	('galK')
galactose1P->UDP-galactose	('galT')	'galactose1P->UDP-galactose'	('galT')
UDP-galactose->UDP-glucose	('galE' | 'capD')	'UDP-galactose->UDP-glucose'	('galE' | 'capD')
galactose degradation	(('galactose->alphagalactose') & ('alphagalactose->galactose1P') & ('galactose1P->UDP-galactose') & ('UDP-galactose->UDP-glucose'))	'galactose degradation'	((('galM')) & (('galK')) & (('galT')) & (('galE' | 'capD')))
mannose6P->fructose6P	('manA')	'mannose6P->fructose6P'	('manA')
mannose degradation	('mannose6P->fructose6P')	'mannose degradation'	(('manA'))
fucose->fuculose	('fucI')	'fucose->fuculose'	('fucI')
fuculose->fuculose1P	('fucK')	'fuculose->fuculose1P'	('fucK')
fuculose1P->glyceroneP	('fucA')	'fuculose1P->glyceroneP'	('fucA')
fucose degradation	(('fucose->fuculose') & ('fuculose->fuculose1P') & ('fuculose1P->glyceroneP'))	'fucose degradation'	((('fucI')) & (('fucK')) & (('fucA')))
fructose->fructose6P	('scrK' | 'fruK')	'fructose->fructose6P'	('scrK' | 'fruK')
fructose degradation	('fructose->fructose6P')	'fructose degradation'	(('scrK' | 'fruK'))
glucuronate->fructuronate	('uxaC')	'glucuronate->fructuronate'	('uxaC')
fructuronate->mannonate	('uxuB')	'fructuronate->mannonate'	('uxuB')
mannonate->2Keto3deoxyDgluconate	('uxuA')	'mannonate->2Keto3deoxyDgluconate'	('uxuA')
glucuronate degradation	('glucuronate->fructuronate' & 'fructuronate->mannonate' & 'mannonate->2Keto3deoxyDgluconate')	'glucuronate degradation'	(('uxaC') & ('uxuB') & ('uxuA'))
isocitrate->alpha-ketoglutarate	('icd' | 'hicdh')	'isocitrate->alpha-ketoglutarate'	('icd' | 'hicdh')
alpha-ketoglutarate->succinyl-CoA	('pdhD' | 'ogdh' | 'dlst')	'alpha-ketoglutarate->succinyl-CoA'	('pdhD' | 'ogdh' | 'dlst')
isocitrate->glyoxylate+succinate	('aceA')	'isocitrate->glyoxylate+succinate'	('aceA')
glyoxylate->malate	('aceB')	'glyoxylate->malate'	('aceB')
oxaloacetate+acetyl-CoA->citrate	('gltA' | 'crs')	'oxaloacetate+acetyl-CoA->citrate'	('gltA' | 'crs')
glyoxylatecycle_full	(('succinate->fumarate_key') & ('fumarate->malate_full') & ('oxaloacetate<->malate') & ('oxaloacetate+acetyl-CoA->citrate') & ('isocitrate<->citrate') & ('isocitrate->glyoxylate+succinate') & ('glyoxylate->malate'))	'glyoxylatecycle_full'	(((('sdhA' & 'sdhB' & 'sdhC') | ('frdA' & 'frdB' & 'frdC'))) & (('fumI' | ('fumalpha' & 'fumbeta') | 'fumII')) & (('mdh')) & (('gltA' | 'crs')) & (('acnA' | 'acnB')) & (('aceA')) & (('aceB')))
glyoxylatecycle_key	('isocitrate->glyoxylate+succinate')	'glyoxylatecycle_key'	(('aceA'))
TCA cycle_key	('alpha-ketoglutarate->succinyl-CoA')	'TCA cycle_key'	(('pdhD' | 'ogdh' | 'dlst'))
TCA cycle_full	(('glyoxylatecycle_full') & ('isocitrate->alpha-ketoglutarate') & ('alpha-ketoglutarate->succinyl-CoA') & ('succinate<->succinyl-CoA_or'))	'TCA cycle_full'	(((((('sdhA' & 'sdhB' & 'sdhC') | ('frdA' & 'frdB' & 'frdC'))) & (('fumI' | ('fumalpha' & 'fumbeta') | 'fumII')) & (('mdh')) & (('gltA' | 'crs')) & (('acnA' | 'acnB')) & (('aceA')) & (('aceB')))) & (('icd' | 'hicdh')) & (('pdhD' | 'ogdh' | 'dlst')) & (('sucC' | 'sucD')))
TCA cycle_partial	(('glyoxylatecycle_full') | ('isocitrate->alpha-ketoglutarate') | ('alpha-ketoglutarate->succinyl-CoA') | ('succinate<->succinyl-CoA_or'))	'TCA cycle_partial'	(((((('sdhA' & 'sdhB' & 'sdhC') | ('frdA' & 'frdB' & 'frdC'))) & (('fumI' | ('fumalpha' & 'fumbeta') | 'fumII')) & (('mdh')) & (('gltA' | 'crs')) & (('acnA' | 'acnB')) & (('aceA')) & (('aceB')))) | (('icd' | 'hicdh')) | (('pdhD' | 'ogdh' | 'dlst')) | (('sucC' | 'sucD')))
flgNJSTA	('flgN' | 'flgA')	'flgNJSTA'	('flgN' | 'flgA')
flgMfliA	('flgM' | 'fliA')	'flgMfliA'	('flgM' | 'fliA')
flhCflhD	('flhC' | 'flhD')	'flhCflhD'	('flhC' | 'flhD')
fliHIOQPR	('fliH' | 'fliI' | 'fliO' | 'fliQ' | 'fliP' | 'fliR')	'fliHIOQPR'	('fliH' | 'fliI' | 'fliO' | 'fliQ' | 'fliP' | 'fliR')
flhAB	('flhA' | 'flhB' | 'fliRflhB')	'flhAB'	('flhA' | 'flhB' | 'fliRflhB')
fliMN	('fliM' | 'fliN')	'fliMN'	('fliM' | 'fliN')
fliFG	('fliF' | 'fliG')	'fliFG'	('fliF' | 'fliG')
fliEflgBC	('fliE' | 'flgB' | 'flgC')	'fliEflgBC'	('fliE' | 'flgB' | 'flgC')
flgHI	('flgH' | 'flgI')	'flgHI'	('flgH' | 'flgI')
flgFG	('flgF' | 'flgG')	'flgFG'	('flgF' | 'flgG')
flgEfliKflgD	('flgE' | 'fliK' | 'flgD')	'flgEfliKflgD'	('flgE' | 'fliK' | 'flgD')
flgLK	('flgL' | 'flgK')	'flgLK'	('flgL' | 'flgK')
fliCD	('fliC' | 'fliD')	'fliCD'	('fliC' | 'fliD')
flagella_motor	(('motA') | ('motB'))	'flagella_motor'	(((((((('motA'))))))) | ((((((('motB'))))))))
flagella_nonmotor	(('flgNJSTA') | ('flgMfliA') | ('flhCflhD') | ('fliHIOQPR') | ('flhAB') | ('fliMN') | ('fliFG') | ('fliEflgBC') | ('flgHI') | ('flgFG') | ('flgEfliKflgD') | ('flgLK') | ('fliCD'))	'flagella_nonmotor'	((('flgN' | 'flgA')) | (('flgM' | 'fliA')) | (('flhC' | 'flhD')) | (('fliH' | 'fliI' | 'fliO' | 'fliQ' | 'fliP' | 'fliR')) | (('flhA' | 'flhB' | 'fliRflhB')) | (('fliM' | 'fliN')) | (('fliF' | 'fliG')) | (('fliE' | 'flgB' | 'flgC')) | (('flgH' | 'flgI')) | (('flgF' | 'flgG')) | (('flgE' | 'fliK' | 'flgD')) | (('flgL' | 'flgK')) | (('fliC' | 'fliD')))
flagella	(('flagella_motor') & ('flagella_nonmotor'))	'flagella'	((((((((('motA')))))) | (((((('motB')))))))) & (((('flgN' | 'flgA')) | (('flgM' | 'fliA')) | (('flhC' | 'flhD')) | (('fliH' | 'fliI' | 'fliO' | 'fliQ' | 'fliP' | 'fliR')) | (('flhA' | 'flhB' | 'fliRflhB')) | (('fliM' | 'fliN')) | (('fliF' | 'fliG')) | (('fliE' | 'flgB' | 'flgC')) | (('flgH' | 'flgI')) | (('flgF' | 'flgG')) | (('flgE' | 'fliK' | 'flgD')) | (('flgL' | 'flgK')) | (('fliC' | 'fliD')))))
trehalose<->maltose	('treS1')	'trehalose<->maltose'	('treS1')
maltose->glucose	('malQ' | 'jgt')	'maltose->glucose'	('malQ' | 'jgt')
trehalose degradation	('trehalose<->maltose')	'trehalose degradation'	(('treS1'))
maltose degradation	('maltose->glucose')	'maltose degradation'	(('malQ' | 'jgt'))
glucose->G6P	('glk')	'glucose->G6P'	('glk')
G6P<->F6P	('pgi' | 'pgi_arch' | 'pgi-tal' | 'pgi-pmi')	'G6P<->F6P'	('pgi' | 'pgi_arch' | 'pgi-tal' | 'pgi-pmi')
F6P->F16BP	('pfk' | 'pfkA' | 'pfkB' | 'pfkC')	'F6P->F16BP'	('pfk' | 'pfkA' | 'pfkB' | 'pfkC')
F16BP->DHAP+G3P	('fba_2' | 'fba_3' | 'aldo.classI-1' | 'aldo.classI-2' | 'aldo.classII')	'F16BP->DHAP+G3P'	('fba_2' | 'fba_3' | 'aldo.classI-1' | 'aldo.classI-2' | 'aldo.classII')
DHAP<->G3P	('tpi')	'DHAP<->G3P'	('tpi')
3PG<->2PG	('gpmA' | 'gpmB' | 'gpmI' | 'apgM')	'3PG<->2PG'	('gpmA' | 'gpmB' | 'gpmI' | 'apgM')
2PG<->PEP	('eno')	'2PG<->PEP'	('eno')
PEP->pyruvate	('pyk')	'PEP->pyruvate'	('pyk')
oxaloacetate->PEP	('pckA1' | 'pckA2')	'oxaloacetate->PEP'	('pckA1' | 'pckA2')
pyruvate->PEP-ppdk	('ppdK')	'pyruvate->PEP-ppdk'	('ppdK')
F16BP->F6P	('fbpI' | 'fbpII' | 'fbpIII' | 'fbpI-sebp')	'F16BP->F6P'	('fbpI' | 'fbpII' | 'fbpIII' | 'fbpI-sebp')
G6P->6PGL	('gpd')	'G6P->6PGL'	('gpd')
6PGL->6PG	('pgl_1' | 'pgl_2')	'6PGL->6PG'	('pgl_1' | 'pgl_2')
6PG->KDPG	('edd')	'6PG->KDPG'	('edd')
KDPG->pyruvate+G3P	('eda' | 'dgaF' | 'kdpgA')	'KDPG->pyruvate+G3P'	('eda' | 'dgaF' | 'kdpgA')
lactate->pyruvate_and	('lldE' & 'lldF' & 'lldG')	'lactate->pyruvate_and'	('lldE' & 'lldF' & 'lldG')
lactate->pyruvate_or	('lldE' | 'lldF' | 'lldG')	'lactate->pyruvate_or'	('lldE' | 'lldF' | 'lldG')
6PG->5RP	('pgd')	'6PG->5RP'	('pgd')
5RP<->X5P	('rpe')	'5RP<->X5P'	('rpe')
5RP<->R5P	('rpiA' | 'rpiB')	'5RP<->R5P'	('rpiA' | 'rpiB')
G3P+S7P<->E4P+F6P	('tal')	'G3P+S7P<->E4P+F6P'	('tal')
X5P+E4P<->F6P+G3P	('tkt')	'X5P+E4P<->F6P+G3P'	('tkt')
R5P+X5P<->G3P+S7P	('X5P+E4P<->F6P+G3P')	'R5P+X5P<->G3P+S7P'	(('tkt'))
glycolysis-EMP_full	('glucose->G6P') & ('G6P<->F6P') & ('F6P->F16BP') & ('G3P<->PGAP') & ('PGAP<->3PG') & ('3PG<->2PG') & ('2PG<->PEP') & ('PEP->pyruvate')	'glycolysis-EMP_full'	(('glk')) & (('pgi' | 'pgi_arch' | 'pgi-tal' | 'pgi-pmi')) & (('pfk' | 'pfkA' | 'pfkB' | 'pfkC')) & (('gapA.NAD+' | 'gapA.NADP+')) & (('pgk')) & (('gpmA' | 'gpmB' | 'gpmI' | 'apgM')) & (('eno')) & (('pyk'))
glycolysis-ED_full	('glucose->G6P') & ('G6P->6PGL') & ('6PGL->6PG') & ('6PG->KDPG') & ('KDPG->pyruvate+G3P')	'glycolysis-ED_full'	(('glk')) & (('gpd')) & (('pgl_1' | 'pgl_2')) & (('edd')) & (('eda' | 'dgaF' | 'kdpgA'))
glycolysis	('glycolysis-EMP_full' | 'glycolysis-ED_full')	'glycolysis'	((('glk')) & (('pgi' | 'pgi_arch' | 'pgi-tal' | 'pgi-pmi')) & (('pfk' | 'pfkA' | 'pfkB' | 'pfkC')) & (('gapA.NAD+' | 'gapA.NADP+')) & (('pgk')) & (('gpmA' | 'gpmB' | 'gpmI' | 'apgM')) & (('eno')) & (('pyk')) | (('glk')) & (('gpd')) & (('pgl_1' | 'pgl_2')) & (('edd')) & (('eda' | 'dgaF' | 'kdpgA')))
gluconeogenesis_full	(('pyruvate->PEP-ppdk' | 'oxaloacetate->PEP') & ('2PG<->PEP') & ('3PG<->2PG') & ('PGAP<->3PG') & ('G3P<->PGAP') & ('F16BP->F6P') & ('G6P<->F6P'))	'gluconeogenesis_full'	((('ppdK') | ('pckA1' | 'pckA2')) & (('eno')) & (('gpmA' | 'gpmB' | 'gpmI' | 'apgM')) & (('pgk')) & (('gapA.NAD+' | 'gapA.NADP+')) & (('fbpI' | 'fbpII' | 'fbpIII' | 'fbpI-sebp')) & (('pgi' | 'pgi_arch' | 'pgi-tal' | 'pgi-pmi')))
oxppp	('G6P->6PGL') & ('6PGL->6PG') & ('6PG->5RP')	'oxppp'	(('gpd')) & (('pgl_1' | 'pgl_2')) & (('pgd'))
nonoxppp	('5RP<->X5P') & ('5RP<->R5P') & ('X5P+E4P<->F6P+G3P') & ('G3P+S7P<->E4P+F6P')	'nonoxppp'	(('rpe')) & (('rpiA' | 'rpiB')) & (('tkt')) & (('tal'))
ppp	('oxppp' & 'nonoxppp')	'ppp'	((('gpd')) & (('pgl_1' | 'pgl_2')) & (('pgd')) & (('rpe')) & (('rpiA' | 'rpiB')) & (('tkt')) & (('tal')))
5RP->PRPP	('prs')	'5RP->PRPP'	('prs')
GH1	('GH1')	'GH1'	((((((('GH1')))))))
GH2	('GH2')	'GH2'	((((((('GH2')))))))
GH3	('GH3')	'GH3'	((((((('GH3')))))))
GH4	('GH4')	'GH4'	((((((('GH4')))))))
GH5	('GH5')	'GH5'	((((((('GH5')))))))
GH6	('GH6')	'GH6'	((((((('GH6')))))))
GH7	('GH7')	'GH7'	((((((('GH7')))))))
GH8	('GH8')	'GH8'	((((((('GH8')))))))
GH9	('GH9')	'GH9'	((((((('GH9')))))))
GH10	('GH10')	'GH10'	((((((('GH10')))))))
GH11	('GH11')	'GH11'	((((((('GH11')))))))
GH12	('GH12')	'GH12'	((((((('GH12')))))))
GH16	('GH16')	'GH16'	((((((('GH16')))))))
GH18	('GH18')	'GH18'	((((((('GH18')))))))
GH19	('GH19')	'GH19'	((((((('GH19')))))))
GH20	('GH20')	'GH20'	((((((('GH20')))))))
GH23	('GH23')	'GH23'	((((((('GH23')))))))
GH26	('GH26')	'GH26'	((((((('GH26')))))))
GH27	('GH27')	'GH27'	((((((('GH27')))))))
GH30	('GH30')	'GH30'	((((((('GH30')))))))
GH31	('GH31')	'GH31'	((((((('GH31')))))))
GH36	('GH36')	'GH36'	((((((('GH36')))))))
GH39	('GH39')	'GH39'	((((((('GH39')))))))
GH43	('GH43')	'GH43'	((((((('GH43')))))))
GH44	('GH44')	'GH44'	((((((('GH44')))))))
GH45	('GH45')	'GH45'	((((((('GH45')))))))
GH48	('GH48')	'GH48'	((((((('GH48')))))))
GH51	('GH51')	'GH51'	((((((('GH51')))))))
GH52	('GH52')	'GH52'	((((((('GH52')))))))
GH54	('GH54')	'GH54'	((((((('GH54')))))))
GH62	('GH62')	'GH62'	((((((('GH62')))))))
GH74	('GH74')	'GH74'	((((((('GH74')))))))
GH79	('GH79')	'GH79'	((((((('GH79')))))))
GH97	('GH97')	'GH97'	((((((('GH97')))))))
GH98	('GH98')	'GH98'	((((((('GH98')))))))
GH124	('GH124')	'GH124'	((((((('GH124')))))))
GH110	('GH110')	'GH110'	((((((('GH110')))))))
GH113	('GH113')	'GH113'	((((((('GH113')))))))
GH116	('GH116')	'GH116'	((((((('GH116')))))))
GH120	('GH120')	'GH120'	((((((('GH120')))))))
GH134	('GH134')	'GH134'	((((((('GH134')))))))
acetyl-CoA+methylH4MPT->methylH4SPT+CO_full	('cdhC' & 'acsC' & 'acsD')	'acetyl-CoA+methylH4MPT->methylH4SPT+CO_full'	('cdhC' & 'acsC' & 'acsD')
acetyl-CoA+methylH4MPT->methylH4SPT+CO_partial	('cdhC' | 'acsC' | 'acsD')	'acetyl-CoA+methylH4MPT->methylH4SPT+CO_partial'	('cdhC' | 'acsC' | 'acsD')
acetyl-P->acetyl-CoA	('pta1' | 'pta2')	'acetyl-P->acetyl-CoA'	('pta1' | 'pta2')
acetate->acetyl-CoA	('acetyl-P<->acetate' & 'acetyl-P->acetyl-CoA')	'acetate->acetyl-CoA'	(('ackA') & ('pta1' | 'pta2'))
acetate->acetyl-CoA-acss	('acss')	'acetate->acetyl-CoA-acss'	('acss')
methylH4SPT+CoM->methylCoM+methylH4MPT_and	('tmtrA' & 'tmtrB' & 'tmtrC' & 'tmtrD' & 'tmtrE' & 'tmtrF' & 'tmtrG' & 'tmtrH')	'methylH4SPT+CoM->methylCoM+methylH4MPT_and'	('tmtrA' & 'tmtrB' & 'tmtrC' & 'tmtrD' & 'tmtrE' & 'tmtrF' & 'tmtrG' & 'tmtrH')
methylH4SPT+CoM->methylCoM+methylH4MPT_or	('tmtrA' | 'tmtrB' | 'tmtrC' | 'tmtrD' | 'tmtrE' | 'tmtrF' | 'tmtrG' | 'tmtrH')	'methylH4SPT+CoM->methylCoM+methylH4MPT_or'	('tmtrA' | 'tmtrB' | 'tmtrC' | 'tmtrD' | 'tmtrE' | 'tmtrF' | 'tmtrG' | 'tmtrH')
methylCoM+CoB->CoM+CH4_and	('mcrA' & 'mcrB' & 'mcrG' & 'mcr2') | ('mcrC' & 'mcrD')	'methylCoM+CoB->CoM+CH4_and'	('mcrA' & 'mcrB' & 'mcrG' & 'mcr2') | ('mcrC' & 'mcrD')
methylCoM+CoB->CoM+CH4_or	('mcrA' | 'mcrB' | 'mcrG' | 'mcr2' | 'mcrC' | 'mcrD')	'methylCoM+CoB->CoM+CH4_or'	('mcrA' | 'mcrB' | 'mcrG' | 'mcr2' | 'mcrC' | 'mcrD')
methanogenesis_key	('mcrA')	'methanogenesis_key'	('mcrA')
acetate->CH4	(('acetate->acetyl-CoA' & 'cdhC') & ('methylH4SPT+CoM->methylCoM+methylH4MPT_or') & ('methylCoM+CoB->CoM+CH4_or'))	'acetate->CH4'	(((('ackA') & ('pta1' | 'pta2')) & 'cdhC') & (('tmtrA' | 'tmtrB' | 'tmtrC' | 'tmtrD' | 'tmtrE' | 'tmtrF' | 'tmtrG' | 'tmtrH')) & (('mcrA' | 'mcrB' | 'mcrG' | 'mcr2' | 'mcrC' | 'mcrD')))
acetoclastic methanogenesis_full	('acetyl-P<->acetate' & 'acetyl-P->acetyl-CoA' & 'acetyl-CoA+methylH4MPT->methylH4SPT+CO_full' & 'methylH4SPT+CoM->methylCoM+methylH4MPT_or' & 'methylCoM+CoB->CoM+CH4_or')	'acetoclastic methanogenesis_full'	(('ackA') & ('pta1' | 'pta2') & ('cdhC' & 'acsC' & 'acsD') & ('tmtrA' | 'tmtrB' | 'tmtrC' | 'tmtrD' | 'tmtrE' | 'tmtrF' | 'tmtrG' | 'tmtrH') & ('mcrA' | 'mcrB' | 'mcrG' | 'mcr2' | 'mcrC' | 'mcrD'))
acetoclastic methanogenesis_partial	('acetyl-P<->acetate' | 'acetyl-P->acetyl-CoA' | 'acetyl-CoA+methylH4MPT->methylH4SPT+CO_full' | 'methylH4SPT+CoM->methylCoM+methylH4MPT_or' | 'methylCoM+CoB->CoM+CH4_or')	'acetoclastic methanogenesis_partial'	(('ackA') | ('pta1' | 'pta2') | ('cdhC' & 'acsC' & 'acsD') | ('tmtrA' | 'tmtrB' | 'tmtrC' | 'tmtrD' | 'tmtrE' | 'tmtrF' | 'tmtrG' | 'tmtrH') | ('mcrA' | 'mcrB' | 'mcrG' | 'mcr2' | 'mcrC' | 'mcrD'))
acetoclastic methanogenesis_key	('acetyl-CoA+methylH4MPT->methylH4SPT+CO_partial')	'acetoclastic methanogenesis_key'	(('cdhC' | 'acsC' | 'acsD'))
MF+CO2->formylMF_and	(('fwdA' & 'fwdB' & 'fwdC' & 'fwdD' & 'fwdF' & 'fwdH') | ('fwdG' & 'fwdE'))	'MF+CO2->formylMF_and'	(('fwdA' & 'fwdB' & 'fwdC' & 'fwdD' & 'fwdF' & 'fwdH') | ('fwdG' & 'fwdE'))
MF+CO2->formylMF_or	('fwdA' | 'fwdB' | 'fwdC' | 'fwdD' | 'fwdF' | 'fwdH' | 'fwdG' | 'fwdE')	'MF+CO2->formylMF_or'	('fwdA' | 'fwdB' | 'fwdC' | 'fwdD' | 'fwdF' | 'fwdH' | 'fwdG' | 'fwdE')
formylMF+H4MPT->MF+formylH4MPT	('ftr')	'formylMF+H4MPT->MF+formylH4MPT'	('ftr')
formylH4MPT->methenylH4MPT	('mtdch')	'formylH4MPT->methenylH4MPT'	('mtdch')
methenylH4MPT->methyleneH4MPT	('hmd')	'methenylH4MPT->methyleneH4MPT'	('hmd')
methyleneH4MPT->methyl-H4SPT	('mer')	'methyleneH4MPT->methyl-H4SPT'	('mer')
hydrogenotrophic methanogenesis_full	(('MF+CO2->formylMF_or') & ('formylMF+H4MPT->MF+formylH4MPT') & ('formylH4MPT->methenylH4MPT') & ('methenylH4MPT->methyleneH4MPT'))	'hydrogenotrophic methanogenesis_full'	((('fwdA' | 'fwdB' | 'fwdC' | 'fwdD' | 'fwdF' | 'fwdH' | 'fwdG' | 'fwdE')) & (('ftr')) & (('mtdch')) & (('hmd')))
hydrogenotrophic methanogenesis_full1	(('MF+CO2->formylMF_or') & ('formylMF+H4MPT->MF+formylH4MPT') & ('formylH4MPT->methenylH4MPT') & ('methenylH4MPT->methyleneH4MPT') & ('methyleneH4MPT->methyl-H4SPT'))	'hydrogenotrophic methanogenesis_full1'	((('fwdA' | 'fwdB' | 'fwdC' | 'fwdD' | 'fwdF' | 'fwdH' | 'fwdG' | 'fwdE')) & (('ftr')) & (('mtdch')) & (('hmd')) & (('mer')))
hydrogenotrophic methanogenesis_partial	(('MF+CO2->formylMF_or') | ('formylMF+H4MPT->MF+formylH4MPT') | ('formylH4MPT->methenylH4MPT') | ('methenylH4MPT->methyleneH4MPT'))	'hydrogenotrophic methanogenesis_partial'	((('fwdA' | 'fwdB' | 'fwdC' | 'fwdD' | 'fwdF' | 'fwdH' | 'fwdG' | 'fwdE')) | (('ftr')) | (('mtdch')) | (('hmd')))
hydrogenotrophic methanogenesis_partial1	(('MF+CO2->formylMF_or') | ('formylMF+H4MPT->MF+formylH4MPT') | ('formylH4MPT->methenylH4MPT') | ('methenylH4MPT->methyleneH4MPT') | ('methyleneH4MPT->methyl-H4SPT'))	'hydrogenotrophic methanogenesis_partial1'	((('fwdA' | 'fwdB' | 'fwdC' | 'fwdD' | 'fwdF' | 'fwdH' | 'fwdG' | 'fwdE')) | (('ftr')) | (('mtdch')) | (('hmd')) | (('mer')))
hydrogenotrophic methanogenesis_key	(('methyleneH4MPT->methyl-H4SPT') | ('methylH4SPT+CoM->methylCoM+methylH4MPT_or') | ('methylCoM+CoB->CoM+CH4_or'))	'hydrogenotrophic methanogenesis_key'	((('mer')) | (('tmtrA' | 'tmtrB' | 'tmtrC' | 'tmtrD' | 'tmtrE' | 'tmtrF' | 'tmtrG' | 'tmtrH')) | (('mcrA' | 'mcrB' | 'mcrG' | 'mcr2' | 'mcrC' | 'mcrD')))
methanol->methylCoM_and	('mtaB' & 'mtaC')	'methanol->methylCoM_and'	('mtaB' & 'mtaC')
methanol->methylCoM_or	('mtaB' | 'mtaC')	'methanol->methylCoM_or'	('mtaB' | 'mtaC')
methanol->methane methanogenesis	('methanol->methylCoM_or' & 'methylCoM+CoB->CoM+CH4_or')	'methanol->methane methanogenesis'	(('mtaB' | 'mtaC') & ('mcrA' | 'mcrB' | 'mcrG' | 'mcr2' | 'mcrC' | 'mcrD'))
hydrogenotrophic methanogenesis	('ftr' & 'mtdch' & 'mtd' & 'mer')	'hydrogenotrophic methanogenesis'	('ftr' & 'mtdch' & 'mtd' & 'mer')
TMAO->trimethylamine	('torA' | 'torZ' | 'torC' | 'torY')	'TMAO->trimethylamine'	('torA' | 'torZ' | 'torC' | 'torY')
trimethylamine->methylCoM-direct_and	('mtbA' & 'mttB' & 'mttC')	'trimethylamine->methylCoM-direct_and'	('mtbA' & 'mttB' & 'mttC')
trimethylamine->methylCoM-direct_or	('mtbA' | 'mttB' | 'mttC')	'trimethylamine->methylCoM-direct_or'	('mtbA' | 'mttB' | 'mttC')
dimethylamine->methylCoM-direct_and	('mtbA' & 'mtbB' & 'mtbC')	'dimethylamine->methylCoM-direct_and'	('mtbA' & 'mtbB' & 'mtbC')
dimethylamine->methylCoM-direct_or	('mtbA' | 'mtbB' | 'mtbC')	'dimethylamine->methylCoM-direct_or'	('mtbA' | 'mtbB' | 'mtbC')
monomethylamine->methylCoM-direct_and	('mtbA' & 'mtmB' & 'mtmC')	'monomethylamine->methylCoM-direct_and'	('mtbA' & 'mtmB' & 'mtmC')
monomethylamine->methylCoM-direct_or	('mtbA' | 'mtmB' | 'mtmC')	'monomethylamine->methylCoM-direct_or'	('mtbA' | 'mtmB' | 'mtmC')
trimethylamine->dimethylamine	('dmd-tmd')	'trimethylamine->dimethylamine'	('dmd-tmd')
dimethylamine->monomethylamine	('dmd-tmd')	'dimethylamine->monomethylamine'	('dmd-tmd')
dimethylamine->methylCoM	(('dimethylamine->methylCoM-direct_or') | (('dimethylamine->monomethylamine') & ('monomethylamine->methylCoM-direct_or')))	'dimethylamine->methylCoM'	((('mtbA' | 'mtbB' | 'mtbC')) | ((('dmd-tmd')) & (('mtbA' | 'mtmB' | 'mtmC'))))
trimethylamine->methylCoM	(('trimethylamine->methylCoM-direct_or') | (('trimethylamine->dimethylamine') & ('dimethylamine->methylCoM')))	'trimethylamine->methylCoM'	((('mtbA' | 'mttB' | 'mttC')) | ((('dmd-tmd')) & (((('mtbA' | 'mtbB' | 'mtbC')) | ((('dmd-tmd')) & (('mtbA' | 'mtmB' | 'mtmC')))))))
methanethiol->methylCoM	('mmtsA')	'methanethiol->methylCoM'	('mmtsA')
serine pathway	('glyA' | 'agxt' | 'hprA' | 'mtkB')	'serine pathway'	('glyA' | 'agxt' | 'hprA' | 'mtkB')
PHB cycle	('phbC' | 'phaZ' | 'phaZ2')	'PHB cycle'	('phbC' | 'phaZ' | 'phaZ2')
H4MPT pathway	('fae' | 'mtdch')	'H4MPT pathway'	('fae' | 'mtdch')
H4F pathway	('fchA')	'H4F pathway'	('fchA')
RuMP pathway	('hxlA' | 'hps-phi')	'RuMP pathway'	('hxlA' | 'hps-phi')
CH4->CH3OH	(('mmoX' | 'mmoY' | 'mmoZ' | 'mmoC' | 'mmoD') | ('pmoA-amoA' | 'pmoB-amoB' | 'pmoC-amoC'))	'CH4->CH3OH'	(('mmoX' | 'mmoY' | 'mmoZ' | 'mmoC' | 'mmoD') | ('pmoA-amoA' | 'pmoB-amoB' | 'pmoC-amoC'))
CH3OH->CH2O	('mxaF' | 'mxaJ' | 'mxaG' | 'mxaI' | 'mxaA' | 'mxaC' | 'mxaD' | 'mxaK' | 'mxaL' | 'xoxF')	'CH3OH->CH2O'	('mxaF' | 'mxaJ' | 'mxaG' | 'mxaI' | 'mxaA' | 'mxaC' | 'mxaD' | 'mxaK' | 'mxaL' | 'xoxF')
methylene-H4F->methenyl-H4F	('mtdA' | 'folD')	'methylene-H4F->methenyl-H4F'	('mtdA' | 'folD')
methenyl-H4F->formyl-H4F	('fchA')	'methenyl-H4F->formyl-H4F'	('fchA')
formyl-H4F->HCOO-	('ftfL')	'formyl-H4F->HCOO-'	('ftfL')
HCOO->CO2	('fdhAF420' | 'fdhBF420')	'HCOO->CO2'	('fdhAF420' | 'fdhBF420')
CH2O->HCOO-	('fdhA')	'CH2O->HCOO-'	('fdhA')
CH2O->5,10methylene-THMPT	('fae' | 'fae-hps')	'CH2O->5,10methylene-THMPT'	('fae' | 'fae-hps')
5,10methylene-THMPT->5,10methenyl-THMPT	('mtdA' | 'mtdB' | 'hmd')	'5,10methylene-THMPT->5,10methenyl-THMPT'	('mtdA' | 'mtdB' | 'hmd')
formyl-MFR->HCOO-	(('fwdA' & 'fwdB' & 'fwdC' & 'fwdD') & ('fwdE' & 'fwdF' & 'fwdG' & 'fwdH'))	'formyl-MFR->HCOO-'	(('fwdA' & 'fwdB' & 'fwdC' & 'fwdD') & ('fwdE' & 'fwdF' & 'fwdG' & 'fwdH'))
methane oxidation pmo_full	('pmoA-amoA' | 'pmoB-amoB' | 'pmoC-amoC')	'methane oxidation pmo_full'	('pmoA-amoA' | 'pmoB-amoB' | 'pmoC-amoC')
methane oxidation mmo_full	('mmoX' | 'mmoY' | 'mmoZ' | 'mmoC' | 'mmoD')	'methane oxidation mmo_full'	('mmoX' | 'mmoY' | 'mmoZ' | 'mmoC' | 'mmoD')
methanol->formaldehyde	('mxaF' | 'mxaJ' | 'mxaG' | 'mxaI' | 'mxaR' | 'mxaA' | 'mxaC' | 'mxaD' | 'mxaK' | 'mxaL' | 'xoxF')	'methanol->formaldehyde'	('mxaF' | 'mxaJ' | 'mxaG' | 'mxaI' | 'mxaR' | 'mxaA' | 'mxaC' | 'mxaD' | 'mxaK' | 'mxaL' | 'xoxF')
narGHI_and	('narG' & 'narH' & 'narI_dsrM')	'narGHI_and'	('narG' & 'narH' & 'narI_dsrM')
narGHI_or	('narG' | 'narH' | 'narI_dsrM')	'narGHI_or'	('narG' | 'narH' | 'narI_dsrM')
napAB_and	('napA' & 'napB')	'napAB_and'	('napA' & 'napB')
napAB_or	('napA' | 'napB')	'napAB_or'	('napA' | 'napB')
nirSK_and	('nirS' & 'nirK')	'nirSK_and'	('nirS' & 'nirK')
nirSK_or	('nirS' | 'nirK')	'nirSK_or'	('nirS' | 'nirK')
nirBC_and	('nirB' & 'nirC')	'nirBC_and'	('nirB' & (((((('nirC')))))))
nirBC_or	('nirB' | 'nirC')	'nirBC_or'	('nirB' | (((((('nirC')))))))
norBC_and	('norB' & 'norC')	'norBC_and'	('norB' & 'norC')
norBC_or	('norB' | 'norC')	'norBC_or'	('norB' | 'norC')
norVW_and	('norV' & 'norW')	'norVW_and'	('norV' & 'norW')
norVW_or	('norV' | 'norW')	'norVW_or'	('norV' | 'norW')
nasAB_and	('nasA' & 'nasB')	'nasAB_and'	('nasA' & 'nasB')
nasAB_or	('nasA' | 'nasB')	'nasAB_or'	('nasA' | 'nasB')
hzsABC_and	('hzsA' & 'hzsB' & 'hzsC')	'hzsABC_and'	('hzsA' & 'hzsB' & 'hzsC')
hzsABC_or	('hzsA' | 'hzsB' | 'hzsC')	'hzsABC_or'	('hzsA' | 'hzsB' | 'hzsC')
nifDKH_and	('nifD' & 'nifK' & 'nifH')	'nifDKH_and'	('nifD' & 'nifK' & 'nifH')
nifDKH_or	('nifD' & 'nifK' & 'nifH')	'nifDKH_or'	('nifD' & 'nifK' & 'nifH')
pmoamoABC_and	('pmoA-amoA' & 'pmoB-amoB' & 'pmoC-amoC')	'pmoamoABC_and'	('pmoA-amoA' & 'pmoB-amoB' & 'pmoC-amoC')
pmoamoABC_or	('pmoA-amoA' | 'pmoB-amoB' | 'pmoC-amoC')	'pmoamoABC_or'	('pmoA-amoA' | 'pmoB-amoB' | 'pmoC-amoC')
vnfDGKH_and	('vnfD' & 'vnfG' & 'vnfK' & 'vnfH')	'vnfDGKH_and'	('vnfD' & 'vnfG' & 'vnfK' & 'vnfH')
vnfDGKH_or	('vnfD' | 'vnfG' | 'vnfK' | 'vnfH')	'vnfDGKH_or'	('vnfD' | 'vnfG' | 'vnfK' | 'vnfH')
nitrate->nitrite_dissimilatory_full	('narGHI_and' | 'napAB_and')	'nitrate->nitrite_dissimilatory_full'	(('narG' & 'narH' & 'narI_dsrM') | ('napA' & 'napB'))
nitrate->nitrite_dissimilatory_partial	(('narG' | 'narH' | 'narI_dsrM') | ('napA' | 'napB'))	'nitrate->nitrite_dissimilatory_partial'	(('narG' | 'narH' | 'narI_dsrM') | ('napA' | 'napB'))
nitrite->nitricoxide_full	('nirS' & 'nirK')	'nitrite->nitricoxide_full'	('nirS' & 'nirK')
nitrite->nitricoxide_partial	('nirS' | 'nirK')	'nitrite->nitricoxide_partial'	('nirS' | 'nirK')
nitricoxide->nitrousoxide_full	(('norBC_and') | ('norVW_and'))	'nitricoxide->nitrousoxide_full'	((('norB' & 'norC')) | (('norV' & 'norW')))
nitricoxide->nitrousoxide_partial	(('norBC_or') | ('norVW_or'))	'nitricoxide->nitrousoxide_partial'	((('norB' | 'norC')) | (('norV' | 'norW')))
nitrousoxide->dinitrogen	('nosZ')	'nitrousoxide->dinitrogen'	('nosZ')
nitrate->nitricoxide_complete	(('nitrate->nitrite_dissimilatory_full') & ('nitrite->nitricoxide_partial'))	'nitrate->nitricoxide_complete'	(((('narG' & 'narH' & 'narI_dsrM') | ('napA' & 'napB'))) & (('nirS' | 'nirK')))
nitrate->nitrousoxide_complete	(('nitrate->nitricoxide_complete') | ('nitricoxide->nitrousoxide_full'))	'nitrate->nitrousoxide_complete'	(((((('narG' & 'narH' & 'narI_dsrM') | ('napA' & 'napB'))) & (('nirS' | 'nirK')))) | (((('norB' & 'norC')) | (('norV' & 'norW')))))
nitrate->dinitrogen_complete	(('nitrate->nitrousoxide_complete') & ('nitrousoxide->dinitrogen'))	'nitrate->dinitrogen_complete'	(((((((('narG' & 'narH' & 'narI_dsrM') | ('napA' & 'napB'))) & (('nirS' | 'nirK')))) | (((('norB' & 'norC')) | (('norV' & 'norW')))))) & (('nosZ')))
nitrite->nitrate_full	('narG' & 'narH')	'nitrite->nitrate_full'	('narG' & 'narH')
nitrite->nitrate_partial	('narG' | 'narH')	'nitrite->nitrate_partial'	('narG' | 'narH')
nitrate->nitrite_assimilatory_full	(('nasAB_and') | ('narB'))	'nitrate->nitrite_assimilatory_full'	((('nasA' & 'nasB')) | ('narB'))
nitrate->nitrite_assimilatory_partial	(('nasAB_or') | ('narB'))	'nitrate->nitrite_assimilatory_partial'	((('nasA' | 'nasB')) | ('narB'))
nitrite->ammonia_dissimilatory_full	(('nirB' & 'nirD' & 'nrfA' & 'nrfH') | ('nirA'))	'nitrite->ammonia_dissimilatory_full'	(('nirB' & 'nirD' & 'nrfA' & 'nrfH') | ('nirA'))
nitrite->ammonia_dissimilatory_partial	(('nirB' | 'nirD' | 'nrfA' | 'nrfH') | ('nirA'))	'nitrite->ammonia_dissimilatory_partial'	(('nirB' | 'nirD' | 'nrfA' | 'nrfH') | ('nirA'))
ammonia->hydroxylamine_full	('pmoamoABC_and')	'ammonia->hydroxylamine_full'	(('pmoA-amoA' & 'pmoB-amoB' & 'pmoC-amoC'))
ammonia->hydroxylamine_partial	('pmoamoABC_or')	'ammonia->hydroxylamine_partial'	(('pmoA-amoA' | 'pmoB-amoB' | 'pmoC-amoC'))
hydroxylamine->nitrite	('hao')	'hydroxylamine->nitrite'	('hao')
nitrite+ammonia->hydrazine_full	(('hzsABC_and'))	'nitrite+ammonia->hydrazine_full'	((('hzsA' & 'hzsB' & 'hzsC')))
nitrite+ammonia->hydrazine_partial	(('hzsABC_or'))	'nitrite+ammonia->hydrazine_partial'	((('hzsA' | 'hzsB' | 'hzsC')))
hydrazine->dinitrogen	('hdh')	'hydrazine->dinitrogen'	('hdh')
dinitrogen->ammonia_full	(('nifD' & 'nifK' & 'nifH' & 'anfG') | ('vnfDGKH_and'))	'dinitrogen->ammonia_full'	(('nifD' & 'nifK' & 'nifH' & 'anfG') | (('vnfD' & 'vnfG' & 'vnfK' & 'vnfH')))
dinitrogen->ammonia_partial	(('nifD' | 'nifK' | 'nifH' | 'anfG') | ('vnfDGKH_or'))	'dinitrogen->ammonia_partial'	(('nifD' | 'nifK' | 'nifH' | 'anfG') | (('vnfD' | 'vnfG' | 'vnfK' | 'vnfH')))
dinitrogen->ammonia_key	('nifH' | 'vnfH')	'dinitrogen->ammonia_key'	('nifH' | 'vnfH')
nitrate reduction_full	(('nitrate->nitrite_dissimilatory_full'))	'nitrate reduction_full'	(((('narG' & 'narH' & 'narI_dsrM') | ('napA' & 'napB'))))
nitrate reduction_partial	(('nitrate->nitrite_dissimilatory_partial'))	'nitrate reduction_partial'	(((('narG' | 'narH' | 'narI_dsrM') | ('napA' | 'napB'))))
denitrification:nitrite->dinitrogen_full	(('nitrite->nitricoxide_full') & ('nitricoxide->nitrousoxide_full') & ('nitrousoxide->dinitrogen'))	'denitrification:nitrite->dinitrogen_full'	((('nirS' & 'nirK')) & (((('norB' & 'norC')) | (('norV' & 'norW')))) & (('nosZ')))
denitrification:nitrite->dinitrogen_partial	(('nitrite->nitricoxide_partial') & ('nitricoxide->nitrousoxide_partial') & ('nitrousoxide->dinitrogen'))	'denitrification:nitrite->dinitrogen_partial'	((('nirS' | 'nirK')) & (((('norB' | 'norC')) | (('norV' | 'norW')))) & (('nosZ')))
denitrification:nitrate->nitrite_full	('nitrate reduction_full')	'denitrification:nitrate->nitrite_full'	((((('narG' & 'narH' & 'narI_dsrM') | ('napA' & 'napB')))))
denitrification:nitrate->nitrite_partial	(('narG' | 'narH' | 'narI_dsrM') | ('napA' | 'napB'))	'denitrification:nitrate->nitrite_partial'	(('narG' | 'narH' | 'narI_dsrM') | ('napA' | 'napB'))
denitrification:nitrate->nitric oxide_full	(('denitrification:nitrate->nitrite_full') & ('nitrite->nitricoxide_full'))	'denitrification:nitrate->nitric oxide_full'	((((((('narG' & 'narH' & 'narI_dsrM') | ('napA' & 'napB')))))) & (('nirS' & 'nirK')))
denitrification:nitrate->nitric oxide_partial	(('denitrification:nitrate->nitrite_partial') & ('nitrite->nitricoxide_partial'))	'denitrification:nitrate->nitric oxide_partial'	(((('narG' | 'narH' | 'narI_dsrM') | ('napA' | 'napB'))) & (('nirS' | 'nirK')))
denitrification:nitrate->nitrous oxide_full	(('denitrification:nitrate->nitrite_full') & ('nitrite->nitricoxide_full') & ('nitricoxide->nitrousoxide_full'))	'denitrification:nitrate->nitrous oxide_full'	((((((('narG' & 'narH' & 'narI_dsrM') | ('napA' & 'napB')))))) & (('nirS' & 'nirK')) & (((('norB' & 'norC')) | (('norV' & 'norW')))))
denitrification:nitrate->nitrous oxide_partial	(('denitrification:nitrate->nitrite_partial') & ('nitrite->nitricoxide_partial') & ('nitricoxide->nitrousoxide_partial'))	'denitrification:nitrate->nitrous oxide_partial'	(((('narG' | 'narH' | 'narI_dsrM') | ('napA' | 'napB'))) & (('nirS' | 'nirK')) & (((('norB' | 'norC')) | (('norV' | 'norW')))))
denitrification:nitrate->dinitrogen_full	(('denitrification:nitrate->nitrite_full') & ('nitrite->nitricoxide_full') & ('nitricoxide->nitrousoxide_full') & ('nitrousoxide->dinitrogen'))	'denitrification:nitrate->dinitrogen_full'	((((((('narG' & 'narH' & 'narI_dsrM') | ('napA' & 'napB')))))) & (('nirS' & 'nirK')) & (((('norB' & 'norC')) | (('norV' & 'norW')))) & (('nosZ')))
denitrification:nitrate->dinitrogen_partial	(('denitrification:nitrate->nitrite_partial') & ('nitrite->nitricoxide_partial') & ('nitricoxide->nitrousoxide_partial') & ('nitrousoxide->dinitrogen'))	'denitrification:nitrate->dinitrogen_partial'	(((('narG' | 'narH' | 'narI_dsrM') | ('napA' | 'napB'))) & (('nirS' | 'nirK')) & (((('norB' | 'norC')) | (('norV' | 'norW')))) & (('nosZ')))
nitrogen fixation_full	(('dinitrogen->ammonia_full'))	'nitrogen fixation_full'	(((('nifD' & 'nifK' & 'nifH' & 'anfG') | (('vnfD' & 'vnfG' & 'vnfK' & 'vnfH')))))
nitrogen fixation_partial	(('dinitrogen->ammonia_partial'))	'nitrogen fixation_partial'	(((('nifD' | 'nifK' | 'nifH' | 'anfG') | (('vnfD' | 'vnfG' | 'vnfK' | 'vnfH')))))
nitrogen fixation_key	(('dinitrogen->ammonia_key'))	'nitrogen fixation_key'	((('nifH' | 'vnfH')))
ammonia oxidation to nitrite_full	(('ammonia->hydroxylamine_full') & ('hydroxylamine->nitrite'))	'ammonia oxidation to nitrite_full'	(((('pmoA-amoA' & 'pmoB-amoB' & 'pmoC-amoC'))) & (('hao')))
ammonia oxidation to nitrite_partial	(('ammonia->hydroxylamine_partial') | ('hydroxylamine->nitrite'))	'ammonia oxidation to nitrite_partial'	(((('pmoA-amoA' | 'pmoB-amoB' | 'pmoC-amoC'))) | (('hao')))
nitrite oxidation_full	('nitrite->nitrate_full')	'nitrite oxidation_full'	(('narG' & 'narH'))
nitrite oxidation_partial	('nitrite->nitrate_partial')	'nitrite oxidation_partial'	(('narG' | 'narH'))
comammox_full	('ammonia oxidation to nitrite_full' & 'nitrite oxidation_full')	'comammox_full'	((((('pmoA-amoA' & 'pmoB-amoB' & 'pmoC-amoC'))) & (('hao'))) & (('narG' & 'narH')))
comammox_partial	('ammonia oxidation to nitrite_partial' & 'nitrite oxidation_partial')	'comammox_partial'	((((('pmoA-amoA' | 'pmoB-amoB' | 'pmoC-amoC'))) | (('hao'))) & (('narG' | 'narH')))
ammonia oxidation to dinitrogen_full	(('hzsA' & 'hzsB' & 'hzsC') & ('hdh'))	'ammonia oxidation to dinitrogen_full'	(('hzsA' & 'hzsB' & 'hzsC') & ('hdh'))
ammonia oxidation to dinitrogen_partial	(('hzsA' | 'hzsB' | 'hzsC') & ('hdh'))	'ammonia oxidation to dinitrogen_partial'	(('hzsA' | 'hzsB' | 'hzsC') & ('hdh'))
anammox_full	('ammonia oxidation to dinitrogen_full')	'anammox_full'	((('hzsA' & 'hzsB' & 'hzsC') & ('hdh')))
anammox_partial	('ammonia oxidation to dinitrogen_partial')	'anammox_partial'	((('hzsA' | 'hzsB' | 'hzsC') & ('hdh')))
assimilatory nitrite reduction	('nirA')	'assimilatory nitrite reduction'	('nirA')
dissimilatory nitrite reduction_full	('nirB' & 'nirD' & 'nrfA' & 'nrfH')	'dissimilatory nitrite reduction_full'	('nirB' & 'nirD' & 'nrfA' & 'nrfH')
dissimilatory nitrite reduction_partial	('nirB' | 'nirD' | 'nrfA' | 'nrfH')	'dissimilatory nitrite reduction_partial'	('nirB' | 'nirD' | 'nrfA' | 'nrfH')
assimilatory nitrate reduction_full	('nitrate->nitrite_assimilatory_full' & 'assimilatory nitrite reduction')	'assimilatory nitrate reduction_full'	(((('nasA' & 'nasB')) | ('narB')) & ('nirA'))
assimilatory nitrate reduction_partial	('nitrate->nitrite_assimilatory_partial' & 'assimilatory nitrite reduction')	'assimilatory nitrate reduction_partial'	(((('nasA' | 'nasB')) | ('narB')) & ('nirA'))
dissimilatory nitrate reduction_full	('nitrate->nitrite_dissimilatory_full' & 'dissimilatory nitrite reduction_full')	'dissimilatory nitrate reduction_full'	((('narG' & 'narH' & 'narI_dsrM') | ('napA' & 'napB')) & ('nirB' & 'nirD' & 'nrfA' & 'nrfH'))
dissimilatory nitrate reduction_partial	('nitrate->nitrite_dissimilatory_partial' & 'dissimilatory nitrite reduction_full')	'dissimilatory nitrate reduction_partial'	((('narG' | 'narH' | 'narI_dsrM') | ('napA' | 'napB')) & ('nirB' & 'nirD' & 'nrfA' & 'nrfH'))
ammonia assimilation to glutamate-GDH	('gudB' | 'gdh2' | 'gdhA_1' | 'gdhA_2')	'ammonia assimilation to glutamate-GDH'	('gudB' | 'gdh2' | 'gdhA_1' | 'gdhA_2')
ammonia assimilation to glutamate-GS_GOGAT	(('gltB' | 'gltD' | 'gltS1') & 'glnA')	'ammonia assimilation to glutamate-GS_GOGAT'	(('gltB' | 'gltD' | 'gltS1') & 'glnA')
ammonia assimilation to glutamate	('ammonia assimilation to glutamate-GDH') | ('ammonia assimilation to glutamate-GS_GOGAT')	'ammonia assimilation to glutamate'	(('gudB' | 'gdh2' | 'gdhA_1' | 'gdhA_2')) | ((('gltB' | 'gltD' | 'gltS1') & 'glnA'))
ammonia assimilation to glutamine-GS	('glnA')	'ammonia assimilation to glutamine-GS'	('glnA')
glutamine to aspartate	('aspB' | 'aspC' | 'yhdR')	'glutamine to aspartate'	('aspB' | 'aspC' | 'yhdR')
phosphatase	('phoA' | 'phoD' | 'phoN' | 'aphA')	'phosphatase'	('phoA' | 'phoD' | 'phoN' | 'aphA')
phytase	('phy' | 'appA')	'phytase'	('phy' | 'appA')
oxygenic photosystem I core	('psaA' | 'psaB' | 'psaC' | 'psaD' | 'psaE' | 'psaF')	'oxygenic photosystem I core'	('psaA' | 'psaB' | 'psaC' | 'psaD' | 'psaE' | 'psaF')
oxygenic photosystem I side	('psaI' | 'psaJ' | 'psaK' | 'psaL' | 'psaM' | 'psaX')	'oxygenic photosystem I side'	('psaI' | 'psaJ' | 'psaK' | 'psaL' | 'psaM' | 'psaX')
oxygenic photosystem I	(('oxygenic photosystem I core') & ('oxygenic photosystem I side'))	'oxygenic photosystem I'	((('psaA' | 'psaB' | 'psaC' | 'psaD' | 'psaE' | 'psaF')) & (('psaI' | 'psaJ' | 'psaK' | 'psaL' | 'psaM' | 'psaX')))
oxygenic photosystem II core	('psbA' | 'psbB' | 'psbC' | 'psbD' | 'psbE' | 'psbF')	'oxygenic photosystem II core'	('psbA' | 'psbB' | 'psbC' | 'psbD' | 'psbE' | 'psbF')
oxygenic photosystem II side	('psbH' | 'psbI' | 'psbJ' | 'psbK' | 'psbL' | 'psbM' | 'psbO' | 'psbP' | 'psbT' | 'psbY' | 'psbZ' | 'psb27' | 'psb28')	'oxygenic photosystem II side'	('psbH' | 'psbI' | 'psbJ' | 'psbK' | 'psbL' | 'psbM' | 'psbO' | 'psbP' | 'psbT' | 'psbY' | 'psbZ' | 'psb27' | 'psb28')
oxygenic photosystem II sidecyano	('psbU' | 'psbV' | 'psbX' | 'psb28-2')	'oxygenic photosystem II sidecyano'	('psbU' | 'psbV' | 'psbX' | 'psb28-2')
oxygenic photosystem II	(('oxygenic photosystem II core') & (('oxygenic photosystem II side') | ('oxygenic photosystem II sidecyano')))	'oxygenic photosystem II'	((('psbA' | 'psbB' | 'psbC' | 'psbD' | 'psbE' | 'psbF')) & ((('psbH' | 'psbI' | 'psbJ' | 'psbK' | 'psbL' | 'psbM' | 'psbO' | 'psbP' | 'psbT' | 'psbY' | 'psbZ' | 'psb27' | 'psb28')) | (('psbU' | 'psbV' | 'psbX' | 'psb28-2'))))
cytochrome b6f	('petA' & 'petB' & 'petC' & 'petD')	'cytochrome b6f'	('petA' & 'petB' & 'petC' & 'petD')
cytochrome b6f_or	('petA' | 'petB' | 'petC' | 'petD' | 'petG' | 'petL' | 'petM' | 'petN')	'cytochrome b6f_or'	('petA' | 'petB' | 'petC' | 'petD' | 'petG' | 'petL' | 'petM' | 'petN')
photosynthetic ETC	('petE' & 'petF' & 'petH' & 'petJ')	'photosynthetic ETC'	('petE' & 'petF' & 'petH' & 'petJ')
photosynthetic ETC_or	('petE' | 'petF' | 'petH' | 'petJ')	'photosynthetic ETC_or'	('petE' | 'petF' | 'petH' | 'petJ')
anoxygenic photosystem II RC	('pufL' | 'pufM' | 'puhA' | 'pufX' | 'pufC')	'anoxygenic photosystem II RC'	('pufL' | 'pufM' | 'puhA' | 'pufX' | 'pufC')
anoxygenic photosystem II LH B870	('pufA' | 'pufB')	'anoxygenic photosystem II LH B870'	('pufA' | 'pufB')
anoxygenic photosystem II LH B800B850	('pucA' | 'pucB')	'anoxygenic photosystem II LH B800B850'	('pucA' | 'pucB')
anoxygenic photosystem II LH	(('anoxygenic photosystem II LH B870') | ('anoxygenic photosystem II LH B800B850'))	'anoxygenic photosystem II LH'	((('pufA' | 'pufB')) | (('pucA' | 'pucB')))
anoxygenic photosystem I RC	('pscA' | 'pscB' | 'pscC' | 'pscD')	'anoxygenic photosystem I RC'	('pscA' | 'pscB' | 'pscC' | 'pscD')
anoxygenic photosystem I bacteriochlorophyll A	('fmoA')	'anoxygenic photosystem I bacteriochlorophyll A'	('fmoA')
anoxygenic photosystem I chlorosome	('csmA' | 'csmB' | 'csmC' | 'csmD' | 'csmE' | 'csmF' | 'csmH' | 'csmI' | 'csmJ' | 'csmX')	'anoxygenic photosystem I chlorosome'	('csmA' | 'csmB' | 'csmC' | 'csmD' | 'csmE' | 'csmF' | 'csmH' | 'csmI' | 'csmJ' | 'csmX')
phycobilisome allophycocyanin	('apcA' | 'apcB' | 'apcC' | 'apcD' | 'apcE' | 'apcF')	'phycobilisome allophycocyanin'	('apcA' | 'apcB' | 'apcC' | 'apcD' | 'apcE' | 'apcF')
phycobilisome phycocyanin	('cpcA' | 'cpcB' | 'cpcC' | 'cpcD' | 'cpcE' | 'cpcF' | 'rpcG' | 'cpcG')	'phycobilisome phycocyanin'	('cpcA' | 'cpcB' | 'cpcC' | 'cpcD' | 'cpcE' | 'cpcF' | 'rpcG' | 'cpcG')
phycobilisome phycoerythrocyanin	('pecA' | 'pecB' | 'pecC' | 'pecE' | 'pecF')	'phycobilisome phycoerythrocyanin'	('pecA' | 'pecB' | 'pecC' | 'pecE' | 'pecF')
phycobilisome phycoerythrin	('cpeA' | 'cpeB' | 'cpeC' | 'cpeD' | 'cpeE' | 'cpeR' | 'cpeS' | 'cpeT' | 'cpeU' | 'cpeY' | 'cpeZ')	'phycobilisome phycoerythrin'	('cpeA' | 'cpeB' | 'cpeC' | 'cpeD' | 'cpeE' | 'cpeR' | 'cpeS' | 'cpeT' | 'cpeU' | 'cpeY' | 'cpeZ')
phycobilisome chlorophyll a/b	('pcbA' | 'pcbB' | 'pcbC' | 'pcbD' | 'pcbE' | 'pcbF' | 'pcbG' | 'pcbH')	'phycobilisome chlorophyll a/b'	('pcbA' | 'pcbB' | 'pcbC' | 'pcbD' | 'pcbE' | 'pcbF' | 'pcbG' | 'pcbH')
protoporphyrin IX->Mg protoporphyrin IX	('bchH')	'protoporphyrin IX->Mg protoporphyrin IX'	('bchH')
Mg protoporphyrin IX->Mg protoporphyrin IX 13-monomethyl ester	('bchM')	'Mg protoporphyrin IX->Mg protoporphyrin IX 13-monomethyl ester'	('bchM')
Mg protoporphyrin IX 13-monomethyl ester->divinyl protochlorophyllide	('bchE' | 'chlE')	'Mg protoporphyrin IX 13-monomethyl ester->divinyl protochlorophyllide'	('bchE' | 'chlE')
divinyl protochlorophyllide->protochlorophyllide	('bciB' | 'bchJ')	'divinyl protochlorophyllide->protochlorophyllide'	('bciB' | 'bchJ')
protochlorophyllide->chlorophyllide a	('por' | 'chlL')	'protochlorophyllide->chlorophyllide a'	('por' | 'chlL')
chlorophyllide a->8ethyl12methyl3vinyl bacteriochlorophyllide d	('bciC')	'chlorophyllide a->8ethyl12methyl3vinyl bacteriochlorophyllide d'	('bciC')
chlorophyllide a->3hydroxyethyl bacteriochlorophyllide a	('bchX' | 'bchF')	'chlorophyllide a->3hydroxyethyl bacteriochlorophyllide a'	('bchX' | 'bchF')
8ethyl12methyl3vinyl bacteriochlorophyllide d->bacteriochlorophyllide d	('bchV')	'8ethyl12methyl3vinyl bacteriochlorophyllide d->bacteriochlorophyllide d'	('bchV')
3hydroxyethyl bacteriochlorophyllide a->bacteriochlorophyllide a	('bchC')	'3hydroxyethyl bacteriochlorophyllide a->bacteriochlorophyllide a'	('bchC')
bacteriochlorophyllide d->bacteriochlorophyllide c	('bchU')	'bacteriochlorophyllide d->bacteriochlorophyllide c'	('bchU')
bacteriochlorophyllide d->bacteriochlorophyll d	('bchK')	'bacteriochlorophyllide d->bacteriochlorophyll d'	('bchK')
bacteriochlorophyllide c->bacteriochlorophyll c	('bchK')	'bacteriochlorophyllide c->bacteriochlorophyll c'	('bchK')
bacteriochlorophyllide c->bacteriochlorophyll e	('bciD')	'bacteriochlorophyllide c->bacteriochlorophyll e'	('bciD')
bacteriochlorophyllide a->geranylgeranyl bacteriochlorophyllide a	('bchG')	'bacteriochlorophyllide a->geranylgeranyl bacteriochlorophyllide a'	('bchG')
bacteriochlorophyllide b->geranylgeranyl bacteriochlorophyllide b	('bchG')	'bacteriochlorophyllide b->geranylgeranyl bacteriochlorophyllide b'	('bchG')
oxygenic chlorophyll a synthesis	('bchG')	'oxygenic chlorophyll a synthesis'	('bchG')
geranylgeranyl bacteriochlorophyllide a->bacteriochlorophyll a	('bchP')	'geranylgeranyl bacteriochlorophyllide a->bacteriochlorophyll a'	('bchP')
geranylgeranyl bacteriochlorophyllide b->bacteriochlorophyll b	('bchP')	'geranylgeranyl bacteriochlorophyllide b->bacteriochlorophyll b'	('bchP')
bacteriochlorophyllide a->bacteriochlorophyll a	(('bacteriochlorophyllide a->geranylgeranyl bacteriochlorophyllide a') & ('geranylgeranyl bacteriochlorophyllide a->bacteriochlorophyll a'))	'bacteriochlorophyllide a->bacteriochlorophyll a'	((('bchG')) & (('bchP')))
bacteriochlorophyllide b->bacteriochlorophyll b	(('bacteriochlorophyllide b->geranylgeranyl bacteriochlorophyllide b') & ('geranylgeranyl bacteriochlorophyllide b->bacteriochlorophyll b'))	'bacteriochlorophyllide b->bacteriochlorophyll b'	((('bchG')) & (('bchP')))
protoporphyrin IX->chlorophyllide a	(('protoporphyrin IX->Mg protoporphyrin IX') & ('Mg protoporphyrin IX->Mg protoporphyrin IX 13-monomethyl ester') & ('Mg protoporphyrin IX 13-monomethyl ester->divinyl protochlorophyllide') & ('divinyl protochlorophyllide->protochlorophyllide') & ('protochlorophyllide->chlorophyllide a'))	'protoporphyrin IX->chlorophyllide a'	((('bchH')) & (('bchM')) & (('bchE' | 'chlE')) & (('bciB' | 'bchJ')) & (('por' | 'chlL')))
chlorophyllide a->bacteriochlorophyllide d	('bciC' & 'bchV')	'chlorophyllide a->bacteriochlorophyllide d'	('bciC' & 'bchV')
chlorophyllide a->bacteriochlorophyllide a	(('bchX' | 'bchF') & 'bchC')	'chlorophyllide a->bacteriochlorophyllide a'	(('bchX' | 'bchF') & 'bchC')
protoporphyrin IX->bacteriochlorophyllide d	(('protoporphyrin IX->chlorophyllide a') & ('chlorophyllide a->bacteriochlorophyllide d'))	'protoporphyrin IX->bacteriochlorophyllide d'	((((('bchH')) & (('bchM')) & (('bchE' | 'chlE')) & (('bciB' | 'bchJ')) & (('por' | 'chlL')))) & (('bciC' & 'bchV')))
protoporphyrin IX->bacteriochlorophyllide a	(('protoporphyrin IX->chlorophyllide a') & ('chlorophyllide a->bacteriochlorophyllide a'))	'protoporphyrin IX->bacteriochlorophyllide a'	((((('bchH')) & (('bchM')) & (('bchE' | 'chlE')) & (('bciB' | 'bchJ')) & (('por' | 'chlL')))) & ((('bchX' | 'bchF') & 'bchC')))
bacteriochlorophyllide d->bacteriochlorophyll c	(('bacteriochlorophyllide d->bacteriochlorophyllide c') & ('bacteriochlorophyllide c->bacteriochlorophyll c'))	'bacteriochlorophyllide d->bacteriochlorophyll c'	((('bchU')) & (('bchK')))
bacteriochlorophyllide d->bacteriochlorophyll e	(('bacteriochlorophyllide d->bacteriochlorophyllide c') & ('bacteriochlorophyllide c->bacteriochlorophyll e'))	'bacteriochlorophyllide d->bacteriochlorophyll e'	((('bchU')) & (('bciD')))
bacteriochlorophyll a synthesis	(('protoporphyrin IX->chlorophyllide a') & ('chlorophyllide a->bacteriochlorophyllide a') & ('bacteriochlorophyllide a->bacteriochlorophyll a'))	'bacteriochlorophyll a synthesis'	((((('bchH')) & (('bchM')) & (('bchE' | 'chlE')) & (('bciB' | 'bchJ')) & (('por' | 'chlL')))) & ((('bchX' | 'bchF') & 'bchC')) & (((('bchG')) & (('bchP')))))
bacteriochlorophyll b synthesis	(('protoporphyrin IX->chlorophyllide a') & ('chlorophyllide a->bacteriochlorophyllide a') & ('bacteriochlorophyllide a->bacteriochlorophyll a'))	'bacteriochlorophyll b synthesis'	((((('bchH')) & (('bchM')) & (('bchE' | 'chlE')) & (('bciB' | 'bchJ')) & (('por' | 'chlL')))) & ((('bchX' | 'bchF') & 'bchC')) & (((('bchG')) & (('bchP')))))
bacteriochlorophyll c synthesis	(('protoporphyrin IX->chlorophyllide a') & ('chlorophyllide a->bacteriochlorophyllide d') & ('bacteriochlorophyllide d->bacteriochlorophyll c'))	'bacteriochlorophyll c synthesis'	((((('bchH')) & (('bchM')) & (('bchE' | 'chlE')) & (('bciB' | 'bchJ')) & (('por' | 'chlL')))) & (('bciC' & 'bchV')) & (((('bchU')) & (('bchK')))))
bacteriochlorophyll d synthesis	(('protoporphyrin IX->chlorophyllide a') & ('chlorophyllide a->bacteriochlorophyllide d') & ('bacteriochlorophyllide d->bacteriochlorophyll d'))	'bacteriochlorophyll d synthesis'	((((('bchH')) & (('bchM')) & (('bchE' | 'chlE')) & (('bciB' | 'bchJ')) & (('por' | 'chlL')))) & (('bciC' & 'bchV')) & (('bchK')))
bacteriochlorophyll e synthesis	(('protoporphyrin IX->chlorophyllide a') & ('chlorophyllide a->bacteriochlorophyllide d') & ('bacteriochlorophyllide d->bacteriochlorophyll e'))	'bacteriochlorophyll e synthesis'	((((('bchH')) & (('bchM')) & (('bchE' | 'chlE')) & (('bciB' | 'bchJ')) & (('por' | 'chlL')))) & (('bciC' & 'bchV')) & (((('bchU')) & (('bciD')))))
GGPP->phytoene	('crtB')	'GGPP->phytoene'	('crtB')
phytoene->phytofluene	('crtI' | 'crtP')	'phytoene->phytofluene'	('crtI' | 'crtP')
phytofluene->zeta carotene	('crtI' | 'crtP')	'phytofluene->zeta carotene'	('crtI' | 'crtP')
zeta carotene->neurosporene	('crtI' | 'crtQ')	'zeta carotene->neurosporene'	('crtI' | 'crtQ')
neurosporene->hydroxy-neurosporene	('crtC')	'neurosporene->hydroxy-neurosporene'	('crtC')
hydroxy-neurosporene->demethyl-spheroidene	('crtD')	'hydroxy-neurosporene->demethyl-spheroidene'	('crtD')
demethyl-spheroidene->spheroidene	('crtF')	'demethyl-spheroidene->spheroidene'	('crtF')
spheroidene->spheroidenone	('crtA')	'spheroidene->spheroidenone'	('crtA')
neurosporene->lycopene	('crtI' | 'crtQ')	'neurosporene->lycopene'	('crtI' | 'crtQ')
lycopene->gamma carotene	('crtY' | 'crtL1' | 'cruA')	'lycopene->gamma carotene'	('crtY' | 'crtL1' | 'cruA')
gamma carotene->beta carotene	('crtY' | 'crtL1' | 'cruA')	'gamma carotene->beta carotene'	('crtY' | 'crtL1' | 'cruA')
beta carotene->beta isorenieratene	('crtU')	'beta carotene->beta isorenieratene'	('crtU')
beta isorenieratene->isorenieratene	('crtU')	'beta isorenieratene->isorenieratene'	('crtU')
gamma carotene->chlorobactene	('crtU')	'gamma carotene->chlorobactene'	('crtU')
lycopene->tetrahydro-spirilloxanthin	('crtC' & 'crtF')	'lycopene->tetrahydro-spirilloxanthin'	('crtC' & 'crtF')
lycopene->spirilloxanthin	('crtC' & 'crtD' & 'crtF')	'lycopene->spirilloxanthin'	('crtC' & 'crtD' & 'crtF')
lycopene->okenone	('crtU')	'lycopene->okenone'	('crtU')
neurosporene->spheroidene	('crtC' & 'crtD' & 'crtF')	'neurosporene->spheroidene'	('crtC' & 'crtD' & 'crtF')
neurosporene biosynthesis	(('GGPP->phytoene') & ('phytoene->phytofluene') & ('phytofluene->zeta carotene') & ('zeta carotene->neurosporene'))	'neurosporene biosynthesis'	((('crtB')) & (('crtI' | 'crtP')) & (('crtI' | 'crtP')) & (('crtI' | 'crtQ')))
lycopene biosynthesis	(('neurosporene biosynthesis') & ('neurosporene->lycopene'))	'lycopene biosynthesis'	((((('crtB')) & (('crtI' | 'crtP')) & (('crtI' | 'crtP')) & (('crtI' | 'crtQ')))) & (('crtI' | 'crtQ')))
gammacarotene biosynthesis	(('lycopene biosynthesis') & ('lycopene->gamma carotene'))	'gammacarotene biosynthesis'	((((((('crtB')) & (('crtI' | 'crtP')) & (('crtI' | 'crtP')) & (('crtI' | 'crtQ')))) & (('crtI' | 'crtQ')))) & (('crtY' | 'crtL1' | 'cruA')))
betacarotene biosynthesis	(('gammacarotene biosynthesis') & ('gamma carotene->beta carotene'))	'betacarotene biosynthesis'	((((((((('crtB')) & (('crtI' | 'crtP')) & (('crtI' | 'crtP')) & (('crtI' | 'crtQ')))) & (('crtI' | 'crtQ')))) & (('crtY' | 'crtL1' | 'cruA')))) & (('crtY' | 'crtL1' | 'cruA')))
betaisorenieratene biosynthesis	(('betacarotene biosynthesis') & ('beta carotene->beta isorenieratene'))	'betaisorenieratene biosynthesis'	((((((((((('crtB')) & (('crtI' | 'crtP')) & (('crtI' | 'crtP')) & (('crtI' | 'crtQ')))) & (('crtI' | 'crtQ')))) & (('crtY' | 'crtL1' | 'cruA')))) & (('crtY' | 'crtL1' | 'cruA')))) & (('crtU')))
isorenieratene biosynthesis	(('betaisorenieratene biosynthesis') & ('beta isorenieratene->isorenieratene'))	'isorenieratene biosynthesis'	((((((((((((('crtB')) & (('crtI' | 'crtP')) & (('crtI' | 'crtP')) & (('crtI' | 'crtQ')))) & (('crtI' | 'crtQ')))) & (('crtY' | 'crtL1' | 'cruA')))) & (('crtY' | 'crtL1' | 'cruA')))) & (('crtU')))) & (('crtU')))
chlorobactene biosynthesis	(('gammacarotene biosynthesis') & ('gamma carotene->chlorobactene'))	'chlorobactene biosynthesis'	((((((((('crtB')) & (('crtI' | 'crtP')) & (('crtI' | 'crtP')) & (('crtI' | 'crtQ')))) & (('crtI' | 'crtQ')))) & (('crtY' | 'crtL1' | 'cruA')))) & (('crtU')))
spirilloxanthin biosynthesis	(('lycopene biosynthesis') & (('lycopene->tetrahydro-spirilloxanthin') | ('lycopene->spirilloxanthin')))	'spirilloxanthin biosynthesis'	((((((('crtB')) & (('crtI' | 'crtP')) & (('crtI' | 'crtP')) & (('crtI' | 'crtQ')))) & (('crtI' | 'crtQ')))) & ((('crtC' & 'crtF')) | (('crtC' & 'crtD' & 'crtF'))))
okenone biosynthesis	(('lycopene biosynthesis') & ('lycopene->okenone'))	'okenone biosynthesis'	((((((('crtB')) & (('crtI' | 'crtP')) & (('crtI' | 'crtP')) & (('crtI' | 'crtQ')))) & (('crtI' | 'crtQ')))) & (('crtU')))
spheroidenone biosynthesis	(('neurosporene biosynthesis') & ('neurosporene->spheroidene') & ('spheroidene->spheroidenone'))	'spheroidenone biosynthesis'	((((('crtB')) & (('crtI' | 'crtP')) & (('crtI' | 'crtP')) & (('crtI' | 'crtQ')))) & (('crtC' & 'crtD' & 'crtF')) & (('crtA')))
diaponeurosporene biosynthesis	('crtM' | 'crtN')	'diaponeurosporene biosynthesis'	('crtM' | 'crtN')
hydroxyspheroidenone biosynthesis	('neurosporene biosynthesis') & ('neurosporene->hydroxy-neurosporene')	'hydroxyspheroidenone biosynthesis'	(((('crtB')) & (('crtI' | 'crtP')) & (('crtI' | 'crtP')) & (('crtI' | 'crtQ')))) & (('crtC'))
ggt	('ggt')	'ggt'	((((((('ggt')))))))
pepA_M17	('pepA_M17')	'pepA_M17'	((((((('pepA_M17')))))))
pepA_M42	('pepA_M42')	'pepA_M42'	((((((('pepA_M42')))))))
pepN	('pepN')	'pepN'	((((((('pepN')))))))
pepT	('pepT')	'pepT'	((((((('pepT')))))))
pip	('pip')	'pip'	((((((('pip')))))))
pepP	('pepP')	'pepP'	((((((('pepP')))))))
map	('map')	'map'	((((((('map')))))))
dmpA	('dmpA')	'dmpA'	((((((('dmpA')))))))
pepD_M20	('pepD_M20')	'pepD_M20'	((((((('pepD_M20')))))))
pepD_S1	('pepD_S1')	'pepD_S1'	((((((('pepD_S1')))))))
pepQ	('pepQ')	'pepQ'	((((((('pepQ')))))))
pepX	('pepX')	'pepX'	((((((('pepX')))))))
dcp	('dcp')	'dcp'	((((((('dcp')))))))
cpg	('cpg')	'cpg'	((((((('cpg')))))))
ldcA	('ldcA')	'ldcA'	((((((('ldcA')))))))
E3.4.17.19	('E3.4.17.19')	'E3.4.17.19'	((((((('E3.4.17.19')))))))
pcp	('pcp')	'pcp'	((((((('pcp')))))))
iadA	('iadA')	'iadA'	((((((('iadA')))))))
yqgT	('yqgT')	'yqgT'	((((((('yqgT')))))))
sspA	('sspA')	'sspA'	((((((('sspA')))))))
E3.4.21.50	('E3.4.21.50')	'E3.4.21.50'	((((((('E3.4.21.50')))))))
lon	('lon')	'lon'	((((((('lon')))))))
iga_hap	('iga_hap')	'iga_hap'	((((((('iga_hap')))))))
iga_zmpA	('iga_zmpA')	'iga_zmpA'	((((((('iga_zmpA')))))))
ptrB	('ptrB')	'ptrB'	((((((('ptrB')))))))
clpP	('clpP')	'clpP'	((((((('clpP')))))))
ptrA	('ptrA')	'ptrA'	((((((('ptrA')))))))
prlC	('prlC')	'prlC'	((((((('prlC')))))))
hslV	('hslV')	'hslV'	((((((('hslV')))))))
bepA	('bepA')	'bepA'	((((((('bepA')))))))
cpaA	('cpaA')	'cpaA'	((((((('cpaA')))))))
hofD	('hofD')	'hofD'	((((((('hofD')))))))
pilD	('pilD')	'pilD'	((((((('pilD')))))))
lepB	('lepB')	'lepB'	((((((('lepB')))))))
lspA	('lspA')	'lspA'	((((((('lspA')))))))
psmA	('psmA')	'psmA'	((((((('psmA')))))))
psmB	('psmB')	'psmB'	((((((('psmB')))))))
hyaD	('hyaD')	'hyaD'	((((((('hyaD')))))))
prc	('prc')	'prc'	((((((('prc')))))))
hflB	('hflB')	'hflB'	((((((('hflB')))))))
lonB	('lonB')	'lonB'	((((((('lonB')))))))
hhoB	('hhoB')	'hhoB'	((((((('hhoB')))))))
lonH	('lonH')	'lonH'	((((((('lonH')))))))
degP	('degP')	'degP'	((((((('degP')))))))
degQ	('degQ')	'degQ'	((((((('degQ')))))))
sppA	('sppA')	'sppA'	((((((('sppA')))))))
sohB	('sohB')	'sohB'	((((((('sohB')))))))
ydgD	('ydgD')	'ydgD'	((((((('ydgD')))))))
pfpI	('pfpI')	'pfpI'	((((((('pfpI')))))))
E3.4.11.10	('E3.4.11.10')	'E3.4.11.10'	((((((('E3.4.11.10')))))))
pepE	('pepE')	'pepE'	((((((('pepE')))))))
cpt	('cpt')	'cpt'	((((((('cpt')))))))
gpr	('gpr')	'gpr'	((((((('gpr')))))))
spoIIGA	('spoIIGA')	'spoIIGA'	((((((('spoIIGA')))))))
preP	('preP')	'preP'	((((((('preP')))))))
dacC	('dacC')	'dacC'	((((((('dacC')))))))
dacB	('dacB')	'dacB'	((((((('dacB')))))))
vanY	('vanY')	'vanY'	((((((('vanY')))))))
mepA	('mepA')	'mepA'	((((((('mepA')))))))
pbpG	('pbpG')	'pbpG'	((((((('pbpG')))))))
pqqL	('pqqL')	'pqqL'	((((((('pqqL')))))))
pepO	('pepO')	'pepO'	((((((('pepO')))))))
loiP	('loiP')	'loiP'	((((((('loiP')))))))
pepB	('pepB')	'pepB'	((((((('pepB')))))))
flaK	('flaK')	'flaK'	((((((('flaK')))))))
prtC_M10	('prtC_M10')	'prtC_M10'	((((((('prtC_M10')))))))
prtC_U32	('prtC_U32')	'prtC_U32'	((((((('prtC_U32')))))))
hycI	('hycI')	'hycI'	((((((('hycI')))))))
ypdF	('ypdF')	'ypdF'	((((((('ypdF')))))))
pgtE	('pgtE')	'pgtE'	((((((('pgtE')))))))
tpr	('tpr')	'tpr'	((((((('tpr')))))))
yopJ	('yopJ')	'yopJ'	((((((('yopJ')))))))
yopT	('yopT')	'yopT'	((((((('yopT')))))))
pepF	('pepF')	'pepF'	((((((('pepF')))))))
E3.4.17.14	('E3.4.17.14')	'E3.4.17.14'	((((((('E3.4.17.14')))))))
vanX	('vanX')	'vanX'	((((((('vanX')))))))
lasA	('lasA')	'lasA'	((((((('lasA')))))))
lef	('lef')	'lef'	((((((('lef')))))))
scpA	('scpA')	'scpA'	((((((('scpA')))))))
pepDA	('pepDA')	'pepDA'	((((((('pepDA')))))))
tri	('tri')	'tri'	((((((('tri')))))))
nprB	('nprB')	'nprB'	((((((('nprB')))))))
mtfA	('mtfA')	'mtfA'	((((((('mtfA')))))))
rseP	('rseP')	'rseP'	((((((('rseP')))))))
cps	('cps')	'cps'	((((((('cps')))))))
iaaA	('iaaA')	'iaaA'	((((((('iaaA')))))))
wprA	('wprA')	'wprA'	((((((('wprA')))))))
isp	('isp')	'isp'	((((((('isp')))))))
bpr	('bpr')	'bpr'	((((((('bpr')))))))
epr	('epr')	'epr'	((((((('epr')))))))
sipW	('sipW')	'sipW'	((((((('sipW')))))))
avrRpt2	('avrRpt2')	'avrRpt2'	((((((('avrRpt2')))))))
avrPphB	('avrPphB')	'avrPphB'	((((((('avrPphB')))))))
icsP	('icsP')	'icsP'	((((((('icsP')))))))
mepS	('mepS')	'mepS'	((((((('mepS')))))))
trf2_3	('trf2_3')	'trf2_3'	((((((('trf2_3')))))))
aprE1	('aprE1')	'aprE1'	((((((('aprE1')))))))
aprE2	('aprE2')	'aprE2'	((((((('aprE2')))))))
vpr	('vpr')	'vpr'	((((((('vpr')))))))
dppA	('dppA')	'dppA'	((((((('dppA')))))))
erfK	('erfK')	'erfK'	((((((('erfK')))))))
yydH	('yydH')	'yydH'	((((((('yydH')))))))
cwlK	('cwlK')	'cwlK'	((((((('cwlK')))))))
aprX	('aprX')	'aprX'	((((((('aprX')))))))
frvX	('frvX')	'frvX'	((((((('frvX')))))))
sprE	('sprE')	'sprE'	((((((('sprE')))))))
ptpA	('ptpA')	'ptpA'	((((((('ptpA')))))))
vanXY	('vanXY')	'vanXY'	((((((('vanXY')))))))
ampH	('ampH')	'ampH'	((((((('ampH')))))))
cwlS	('cwlS')	'cwlS'	((((((('cwlS')))))))
lytF	('lytF')	'lytF'	((((((('lytF')))))))
lytE	('lytE')	'lytE'	((((((('lytE')))))))
gluP	('gluP')	'gluP'	((((((('gluP')))))))
ynhG	('ynhG')	'ynhG'	((((((('ynhG')))))))
ybiS	('ybiS')	'ybiS'	((((((('ybiS')))))))
ycfS	('ycfS')	'ycfS'	((((((('ycfS')))))))
mepH	('mepH')	'mepH'	((((((('mepH')))))))
mepM	('mepM')	'mepM'	((((((('mepM')))))))
mpl	('mpl')	'mpl'	((((((('mpl')))))))
ampS	('ampS')	'ampS'	((((((('ampS')))))))
ywaD	('ywaD')	'ywaD'	((((((('ywaD')))))))
E3.4.11.24	('E3.4.11.24')	'E3.4.11.24'	((((((('E3.4.11.24')))))))
zmp1	('zmp1')	'zmp1'	((((((('zmp1')))))))
alpha-LP	('alpha-LP')	'alpha-LP'	((((((('alpha-LP')))))))
zmpA	('zmpA')	'zmpA'	((((((('zmpA')))))))
zmpB_M26	('zmpB_M26')	'zmpB_M26'	((((((('zmpB_M26')))))))
zmpB_M4	('zmpB_M4')	'zmpB_M4'	((((((('zmpB_M4')))))))
nisP	('nisP')	'nisP'	((((((('nisP')))))))
tet	('tet')	'tet'	((((((('tet')))))))
sgcX	('sgcX')	'sgcX'	((((((('sgcX')))))))
ykfC	('ykfC')	'ykfC'	((((((('ykfC')))))))
E3.4.24.32	('E3.4.24.32')	'E3.4.24.32'	((((((('E3.4.24.32')))))))
bapA	('bapA')	'bapA'	((((((('bapA')))))))
E3.4.21.121	('E3.4.21.121')	'E3.4.21.121'	((((((('E3.4.21.121')))))))
impA	('impA')	'impA'	((((((('impA')))))))
pbp4b	('pbp4b')	'pbp4b'	((((((('pbp4b')))))))
ycbB	('ycbB')	'ycbB'	((((((('ycbB')))))))
cwlO	('cwlO')	'cwlO'	((((((('cwlO')))))))
lytH	('lytH')	'lytH'	((((((('lytH')))))))
ripA	('ripA')	'ripA'	((((((('ripA')))))))
ripB	('ripB')	'ripB'	((((((('ripB')))))))
hpxW	('hpxW')	'hpxW'	((((((('hpxW')))))))
E3.4.24.33	('E3.4.24.33')	'E3.4.24.33'	((((((('E3.4.24.33')))))))
pipA	('pipA')	'pipA'	((((((('pipA')))))))
tpdA	('tpdA')	'tpdA'	((((((('tpdA')))))))
prsW	('prsW')	'prsW'	((((((('prsW')))))))
patG	('patG')	'patG'	((((((('patG')))))))
sulfate<->APS	('sat')	'sulfate<->APS'	('sat')
APS<->sulfite_and	('aprA' & 'aprB')	'APS<->sulfite_and'	('aprA' & 'aprB')
APS<->sulfite_or	('aprA' | 'aprB')	'APS<->sulfite_or'	('aprA' | 'aprB')
dsrAB_and	('dsrA' & 'dsrB')	'dsrAB_and'	('dsrA' & 'dsrB')
dsrAB_or	('dsrA' | 'dsrB')	'dsrAB_or'	('dsrA' | 'dsrB')
dsrEFH_and	('dsrE' & 'dsrF' & 'dsrH')	'dsrEFH_and'	('dsrE' & 'dsrF' & 'dsrH')
dsrEFH_or	('dsrE' | 'dsrF' | 'dsrH')	'dsrEFH_or'	('dsrE' | 'dsrF' | 'dsrH')
asrABC_and	('asrA' & 'asrB' & 'asrC')	'asrABC_and'	('asrA' & 'asrB' & 'asrC')
asrABC_or	('asrA' | 'asrB' | 'asrC')	'asrABC_or'	('asrA' | 'asrB' | 'asrC')
sulfate->sulfite-reduction	('APS<->sulfite_and' & 'sulfate<->APS')	'sulfate->sulfite-reduction'	(('aprA' & 'aprB') & ('sat'))
sulfite->sulfide-reduction	(('dsrAB_and' & 'dsrD' & !'dsrEFH_and') | ('asrABC_and') | ('mccA'))	'sulfite->sulfide-reduction'	((('dsrA' & 'dsrB') & 'dsrD' & !('dsrE' & 'dsrF' & 'dsrH')) | (('asrA' & 'asrB' & 'asrC')) | ('mccA'))
sulfate->sulfide-reduction	('sulfate->sulfite-reduction' & 'sulfite->sulfide-reduction')	'sulfate->sulfide-reduction'	((('aprA' & 'aprB') & ('sat')) & ((('dsrA' & 'dsrB') & 'dsrD' & !('dsrE' & 'dsrF' & 'dsrH')) | (('asrA' & 'asrB' & 'asrC')) | ('mccA')))
sreABC_and	('sreA' & 'sreB' & 'sreC')	'sreABC_and'	('sreA' & 'sreB' & 'sreC')
sreABC_or	('sreA' | 'sreB' | 'sreC')	'sreABC_or'	('sreA' | 'sreB' | 'sreC')
shyd_and	('hydG' & 'hydB_4')	'shyd_and'	('hydG' & 'hydB_4')
shyd_or	('hydG' | 'hydB_4')	'shyd_or'	('hydG' | 'hydB_4')
sulfur->sulfide-reduction	('sreABC_and' | 'shyd_and')	'sulfur->sulfide-reduction'	(('sreA' & 'sreB' & 'sreC') | ('hydG' & 'hydB_4'))
sorAB_and	('sorA' & 'sorB')	'sorAB_and'	('sorA' & 'sorB')
sorAB_or	('sorA' | 'sorB')	'sorAB_or'	('sorA' | 'sorB')
soeABC_and	('soeA' & 'soeB' & 'soeC')	'soeABC_and'	('soeA' & 'soeB' & 'soeC')
soeABC_or	('soeA' | 'soeB' | 'soeC')	'soeABC_or'	('soeA' | 'soeB' | 'soeC')
sulfite->sulfate-oxidation	(('APS<->sulfite_and' & 'sulfate<->APS') | ('sorAB_and') | ('soeABC_and'))	'sulfite->sulfate-oxidation'	((('aprA' & 'aprB') & ('sat')) | (('sorA' & 'sorB')) | (('soeA' & 'soeB' & 'soeC')))
sulfide->sulfur-oxidation	(('fccA' & 'fccB') | 'sqr')	'sulfide->sulfur-oxidation'	(('fccA' & 'fccB') | 'sqr')
sulfur->sulfite-oxidation	('dsrAB_and' & 'dsrEFH_and' & !'dsrD')	'sulfur->sulfite-oxidation'	(('dsrA' & 'dsrB') & ('dsrE' & 'dsrF' & 'dsrH') & !'dsrD')
sulfur->sulfate-oxidation	('dsrAB_and' & 'dsrEFH_and' & !'dsrD' & 'APS<->sulfite_and' & 'sulfate<->APS')	'sulfur->sulfate-oxidation'	(('dsrA' & 'dsrB') & ('dsrE' & 'dsrF' & 'dsrH') & !'dsrD' & ('aprA' & 'aprB') & ('sat'))
sulfur->sulfide+sulfite+thiosulfate-disproportionation	('sor')	'sulfur->sulfide+sulfite+thiosulfate-disproportionation'	('sor')
phsABC_and	('phsA' & 'phsB' & 'phsC')	'phsABC_and'	('phsA' & 'phsB' & 'phsC')
phsABC_or	('phsA' | 'phsB' | 'phsC')	'phsABC_or'	('phsA' | 'phsB' | 'phsC')
thiosulfate->sulfite+sulfide-disproportionation	('phsABC_and')	'thiosulfate->sulfite+sulfide-disproportionation'	(('phsA' & 'phsB' & 'phsC'))
thiosulfate->sulfite+sulfide-disproportionation1	('phsABC_and' | 'sseA')	'thiosulfate->sulfite+sulfide-disproportionation1'	(('phsA' & 'phsB' & 'phsC') | 'sseA')
sox_and	('soxB' & 'soxC' & 'soxD')	'sox_and'	('soxB' & 'soxC' & 'soxD')
sox_or	('soxB' | 'soxC' | 'soxD')	'sox_or'	('soxB' | 'soxC' | 'soxD')
thiosulfate->sulfate	('sox_and')	'thiosulfate->sulfate'	(('soxB' & 'soxC' & 'soxD'))
doxAD_and	('doxA' & 'doxD')	'doxAD_and'	('doxA' & 'doxD')
thiosulfate->tetrathionate-oxidation	('doxAD_and' | 'tsdA')	'thiosulfate->tetrathionate-oxidation'	(('doxA' & 'doxD') | 'tsdA')
ttrABC_and	('ttrA' & 'ttrB_dsrO' & 'ttrC')	'ttrABC_and'	('ttrA' & 'ttrB_dsrO' & 'ttrC')
ttrABC_or	('ttrA' | 'ttrB_dsrO' | 'ttrC')	'ttrABC_or'	('ttrA' | 'ttrB_dsrO' | 'ttrC')
tetrathionate->thiosulfate-reduction	('ttrABC_and')	'tetrathionate->thiosulfate-reduction'	(('ttrA' & 'ttrB_dsrO' & 'ttrC'))
DMSO->DMS_and	('dmsA' & 'dmsB' & 'dmsC')	'DMSO->DMS_and'	('dmsA' & 'dmsB' & 'dmsC')
DMSO->DMS_or	('dmsA' | 'dmsB' | 'dmsC')	'DMSO->DMS_or'	('dmsA' | 'dmsB' | 'dmsC')
DMSP->DMS	('dddL')	'DMSP->DMS'	('dddL')
hdr1_and	('hdrA1' & 'hdrB1' & 'hdrC1')	'hdr1_and'	('hdrA1' & 'hdrB1' & 'hdrC1')
hdr1_or	('hdrA1' | 'hdrB1' | 'hdrC1')	'hdr1_or'	('hdrA1' | 'hdrB1' | 'hdrC1')
hdr2_and	('hdrA2' & 'hdrB2' & 'hdrC2')	'hdr2_and'	('hdrA2' & 'hdrB2' & 'hdrC2')
hdr2_or	('hdrA2' | 'hdrB2' | 'hdrC2')	'hdr2_or'	('hdrA2' | 'hdrB2' | 'hdrC2')
sulfate->sulfite-assimilatory	('sulfate->APS-assimilatory_and' & 'APS->sulfite' & 'sulfite->sulfide-assimilatory_and')	'sulfate->sulfite-assimilatory'	(('cysNC' & 'cysN' & 'cysD') & ('cysC' & 'cysH') & (('cysI' & 'cysJ') | 'sir'))
sulfite->sulfide-assimilatory_and	(('cysI' & 'cysJ') | 'sir')	'sulfite->sulfide-assimilatory_and'	(('cysI' & 'cysJ') | 'sir')
sulfite->sulfide-assimilatory_or	('cysI' | 'cysJ' | 'sir')	'sulfite->sulfide-assimilatory_or'	('cysI' | 'cysJ' | 'sir')
APS->sulfite	('cysC' & 'cysH')	'APS->sulfite'	('cysC' & 'cysH')
sulfate->APS-assimilatory_and	('cysNC' & 'cysN' & 'cysD')	'sulfate->APS-assimilatory_and'	('cysNC' & 'cysN' & 'cysD')
sulfate->APS-assimilatory_or	('cysNC' | 'cysN' | 'cysD')	'sulfate->APS-assimilatory_or'	('cysNC' | 'cysN' | 'cysD')
katE	('katE')	'katE'	((((((('katE')))))))
katG	('katG')	'katG'	((((((('katG')))))))
alginate biosynthesis/transport	('algK' | 'algE')	'alginate biosynthesis/transport'	('algK' | (((((('algE')))))))
Psl polysaccharide biosynthesis/export	('pslA' | 'pslB' | 'pslD' | 'pslE' | 'pslF' | 'pslG' | 'pslH' | 'pslI' | 'pslJ' | 'pslK' | 'pslL')	'Psl polysaccharide biosynthesis/export'	('pslA' | 'pslB' | (((((('pslD')))))) | 'pslE' | 'pslF' | 'pslG' | 'pslH' | 'pslI' | 'pslJ' | 'pslK' | 'pslL')
Pel polysaccharide biosynthesis/export	('pelA' | 'pelB' | 'pelC' | 'pelD' | 'pelE' | 'pelF' | 'pelG')	'Pel polysaccharide biosynthesis/export'	('pelA' | 'pelB' | 'pelC' | 'pelD' | 'pelE' | 'pelF' | 'pelG')
Vi polysaccharide biosynthesis/export	('vexA' | 'vexB' | 'vexC' | 'vexD')	'Vi polysaccharide biosynthesis/export'	((((((('vexA')))))) | 'vexB' | 'vexC' | 'vexD')
lipopolysaccharide assembly/export	('lptA' | 'lptB' | 'lptC' | 'lptD' | 'lptE' | 'lptF' | 'lptG')	'lipopolysaccharide assembly/export'	((((((('lptA')))))) | 'lptB' | 'lptC' | 'lptD' | (((((('lptE')))))) | 'lptF' | 'lptG')
colanic acid biosynthesis/exporter	('wzxC' | 'wcaB' | 'wcaC' | 'wcaD' | 'wcaE' | 'wcaF' | 'wcaI' | 'wcaJ' | 'wcaK' | 'wcaL' | 'wcaM')	'colanic acid biosynthesis/exporter'	((((((('wzxC')))))) | 'wcaB' | 'wcaC' | 'wcaD' | 'wcaE' | 'wcaF' | 'wcaI' | 'wcaJ' | 'wcaK' | 'wcaL' | 'wcaM')
exopolysaccharide production	('exoF' | 'exoY')	'exopolysaccharide production'	((((((('exoF')))))) | 'exoY')
hsp10	('groES')	'hsp10'	('groES')
hsp24	('grpE')	'hsp24'	('grpE')
hsp40	('dnaJ')	'hsp40'	('dnaJ')
hsp60	('groEL' | 'cct')	'hsp60'	('groEL' | 'cct')
hsp70	('dnaK')	'hsp70'	('dnaK')
hsp100_key	('hslU')	'hsp100_key'	('hslU')
hsp100_or	('clpA' | 'clpB' | 'clpC' | 'clpE' | 'clpL' | 'clpX' | 'hslU')	'hsp100_or'	('clpA' | 'clpB' | 'clpC' | 'clpE' | 'clpL' | 'clpX' | 'hslU')
hsp100_and	('clpA' & 'clpB' & 'clpC' & 'clpE' & 'clpL' & 'clpX' & 'hslU')	'hsp100_and'	('clpA' & 'clpB' & 'clpC' & 'clpE' & 'clpL' & 'clpX' & 'hslU')
lon_or	(('lon') | ('lonB'))	'lon_or'	(((((((('lon'))))))) | ((((((('lonB'))))))))
heatinducibleTF	('hrcA')	'heatinducibleTF'	('hrcA')
TAsystemTypeII_generalstress	(('mazFE_and') | ('relEB_and'))	'TAsystemTypeII_generalstress'	((('mazF' & 'mazE')) | (('relE' & 'relB')))
phoQP_and	('phoQ' & 'phoP')	'phoQP_and'	('phoQ' & 'phoP')
mazFE_and	('mazF' & 'mazE')	'mazFE_and'	('mazF' & 'mazE')
relEB_and	('relE' & 'relB')	'relEB_and'	('relE' & 'relB')
sodA	('sodA')	'sodA'	((((((('sodA')))))))
cspA	('cspA')	'cspA'	((((((('cspA')))))))
desA	('desA')	'desA'	((((((('desA')))))))
desKR	(('desK') | ('desR'))	'desKR'	(('desK') | ('desR'))
deaD	('deaD')	'deaD'	((((((('deaD')))))))
rnr	('rnr')	'rnr'	((((((('rnr')))))))
pnp	('pnp')	'pnp'	((((((('pnp')))))))
ahpCF	(('ahpC_1' | 'ahpC_2' | 'ahpC_3') & ('ahpF'))	'ahpCF'	(('ahpC_1' | 'ahpC_2' | 'ahpC_3') & ('ahpF'))
glutamate->glutamyl phosphate	('proB')	'glutamate->glutamyl phosphate'	('proB')
glutamyl phosphate->glutamic semialdehyde	('proA')	'glutamyl phosphate->glutamic semialdehyde'	('proA')
pyrroline5carboxylate->proline	('proC')	'pyrroline5carboxylate->proline'	('proC')
glutamate->glutamic semialdehyde	(('glutamate->glutamyl phosphate') & ('glutamyl phosphate->glutamic semialdehyde'))	'glutamate->glutamic semialdehyde'	((('proB')) & (('proA')))
glutamate->proline	(('glutamate->glutamic semialdehyde') & ('pyrroline5carboxylate->proline'))	'glutamate->proline'	((((('proB')) & (('proA')))) & (('proC')))
ornithine->pyrroline5carboxylate	('rocD')	'ornithine->pyrroline5carboxylate'	('rocD')
ornithine->proline	(('ocd') | (('rocD') & ('proC')))	'ornithine->proline'	(('ocd') | (('rocD') & ('proC')))
proline_biosynthesis	(('glutamate->proline') | ('ornithine->proline'))	'proline_biosynthesis'	((((((('proB')) & (('proA')))) & (('proC')))) | ((('ocd') | (('rocD') & ('proC')))))
UDP-glucose+G6P->trehalose 6-phospate	('otsA')	'UDP-glucose+G6P->trehalose 6-phospate'	('otsA')
trehalose 6-phospate->trehalose	(('otsB') | ('tps'))	'trehalose 6-phospate->trehalose'	(('otsB') | ('tps'))
trehalose_biosynthesis	(('UDP-glucose+G6P->trehalose 6-phospate') & ('trehalose 6-phospate->trehalose'))	'trehalose_biosynthesis'	((('otsA')) & ((('otsB') | ('tps'))))
choline->betaine aldehyde	('betA' | 'gbsB' | 'codA')	'choline->betaine aldehyde'	('betA' | 'gbsB' | 'codA')
betaine aldehyde->betaine	('betB' | 'codA')	'betaine aldehyde->betaine'	('betB' | 'codA')
betaine_biosynthesis	(('choline->betaine aldehyde') & ('betaine aldehyde->betaine'))	'betaine_biosynthesis'	((('betA' | 'gbsB' | 'codA')) & (('betB' | 'codA')))
glucosylglycerate_biosynthesis	(('ggs') | ('gpgP'))	'glucosylglycerate_biosynthesis'	(('ggs') | ('gpgP'))
mannosylglucosylglycerate_biosynthesis	(('mggA' & 'gpgP') | ('ggs' & 'mggS'))	'mannosylglucosylglycerate_biosynthesis'	(('mggA' & 'gpgP') | ('ggs' & 'mggS'))
mannosylglycerate_biosynthesis	(('mngA' & 'mngB') | ('mgs'))	'mannosylglycerate_biosynthesis'	(('mngA' & 'mngB') | ('mgs'))
proline transport	('proP')	'proline transport'	((((((('proP')))))))
glycine betaine/proline transport system	(('proV') | ('proW') | ('proX'))	'glycine betaine/proline transport system'	(('proV') | ('proW') | ('proX'))
glycine betaine transporter	('betL')	'glycine betaine transporter'	((((((('betL')))))))
choline/glycine/proline betaine transport	('betT')	'choline/glycine/proline betaine transport'	((((((('betT')))))))
mechanosensitive channel	(('mscS') | ('mscL'))	'mechanosensitive channel'	(('mscS') | ((((((('mscL'))))))))
TF_redox	(('oxyR') | ('soxR') | ('perR') | ('ohrR'))	'TF_redox'	(('oxyR') | ('soxR') | ('perR') | ('ohrR'))
urease	(('ureA') | ('ureB') | ('ureC') | ('ureAB'))	'urease'	(('ureA') | ('ureB') | ('ureC') | ('ureAB'))
arginine antiporter	('adiC')	'arginine antiporter'	((((((('adiC')))))))
adiA	('adiA')	'adiA'	((((((('adiA')))))))
speA	('speA')	'speA'	((((((('speA')))))))
pdaD	('pdaD')	'pdaD'	((((((('pdaD')))))))
arginine decarboxylase	(('adiA') | ('speA') | ('pdaD'))	'arginine decarboxylase'	(((((((('adiA'))))))) | ((((((('speA'))))))) | ((((((('pdaD'))))))))
arginine amidinase	('rocF')	'arginine amidinase'	('rocF')
glutaminase	('glsA')	'glutaminase'	('glsA')
glutamate dependent acid tolerance	(('gadAB') | ('gadC'))	'glutamate dependent acid tolerance'	(('gadAB') | ((((((('gadC'))))))))
lysine decarboxylase	('cadA')	'lysine decarboxylase'	('cadA')
lysine antiporter	('cadB')	'lysine antiporter'	('cadB')
ornithine decarboxylase	('speF')	'ornithine decarboxylase'	('speF')
ornithine antiporter	('potE')	'ornithine antiporter'	('potE')
hdeAB	(('hdeA') | ('hdeB'))	'hdeAB'	(('hdeA') | ('hdeB'))
cfa	('cfa')	'cfa'	((((((('cfa')))))))
nrsSR	(('nrsS') & ('nrsR'))	'nrsSR'	(('nrsS') & ('nrsR'))
arcAB	(('arcA') & ('arcB'))	'arcAB'	(('arcA') & ('arcB'))
devSR	(('devS') & ('devR'))	'devSR'	(('devS') & ('devR'))
regAB	(('regA') & ('regB'))	'regAB'	(('regA') & ('regB'))
resED	(('resE') & ('resD'))	'resED'	(('resE') & ('resD'))
prrAB	(('prrA') & ('prrB'))	'prrAB'	(('prrA') & ('prrB'))
nreB	('nreB')	'nreB'	((((((('nreB')))))))
baeRS	(('baeR') & ('baeS'))	'baeRS'	(('baeR') & ('baeS'))
cpxAR	(('cpxA') & ('cpxR'))	'cpxAR'	(('cpxA') & ('cpxR'))
cpxP	('cpxP')	'cpxP'	((((((('cpxP')))))))
phage shock protein	(('pspA') | ('pspB') | ('pspC') | ('pspD'))	'phage shock protein'	(('pspA') | ('pspB') | ('pspC') | ('pspD'))
aaeB	('aaeB')	'aaeB'	((((((('aaeB')))))))
aap_full	('aapJ' & 'aapQ' & 'aapM' & 'aapP')	'aap_full'	('aapJ' & 'aapQ' & 'aapM' & 'aapP')
aap_key	('aapJ')	'aap_key'	('aapJ')
abgT	('abgT')	'abgT'	((((((('abgT')))))))
acrD	('acrD')	'acrD'	((((((('acrD')))))))
acrF	('acrF')	'acrF'	((((((('acrF')))))))
actP	('actP')	'actP'	((((((('actP')))))))
ade_full	('adeB' & 'adeC')	'ade_full'	('adeB' & 'adeC')
ade_partial	('adeB' | 'adeC')	'ade_partial'	('adeB' | 'adeC')
adiC	('adiC')	'adiC'	((((((('adiC')))))))
afu_full	('afuA' & 'afuB' & 'afuC')	'afu_full'	('afuA' & 'afuB' & 'afuC')
afu_key	('afuA')	'afu_key'	('afuA')
aga_full	('agaEIIA' & 'agaEIIB' & 'agaEIIC' & 'agaEIID')	'aga_full'	('agaEIIA' & 'agaEIIB' & 'agaEIIC' & 'agaEIID')
aga_partial	('agaEIIA' | 'agaEIIB' | 'agaEIIC' | 'agaEIID')	'aga_partial'	('agaEIIA' | 'agaEIIB' | 'agaEIIC' | 'agaEIID')
agl_full	('aglE' & 'aglF' & 'aglG' & ('aglK' | 'msmX'))	'agl_full'	('aglE' & 'aglF' & 'aglG' & ('aglK' | 'msmX'))
agl_key	('aglE')	'agl_key'	('aglE')
agu_full	('aguE' & 'aguF' & 'aguG')	'agu_full'	('aguE' & 'aguF' & 'aguG')
agu_key	('aguE')	'agu_key'	('aguE')
algE	('algE')	'algE'	((((((('algE')))))))
allP	('allP')	'allP'	((((((('allP')))))))
als_full	('alsA' & 'alsB' & 'alsC')	'als_full'	('alsA' & 'alsB' & 'alsC')
als_key	('alsB')	'als_key'	('alsB')
ameC	('ameC')	'ameC'	((((((('ameC')))))))
amiS	('amiS')	'amiS'	((((((('amiS')))))))
ampG	('ampG')	'ampG'	((((((('ampG')))))))
amsL	('amsL')	'amsL'	((((((('amsL')))))))
amt	('amt')	'amt'	((((((('amt')))))))
ansP	('ansP')	'ansP'	((((((('ansP')))))))
aot_full	('aotJ' & 'aotM' & 'aotQ' & 'aotP')	'aot_full'	('aotJ' & 'aotM' & 'aotQ' & 'aotP')
aot_key	('aotJ')	'aot_key'	('aotJ')
ara-1_full	('araN' & 'araP' & 'araQ' & 'msmX')	'ara-1_full'	('araN' & 'araP' & 'araQ' & 'msmX')
ara-1_key	('araN')	'ara-1_key'	('araN')
ara-2_full	('araF' & 'araG' & 'araH')	'ara-2_full'	('araF' & 'araG' & 'araH')
ara-2_key	('araF')	'ara-2_key'	('araF')
araE	('araE')	'araE'	((((((('araE')))))))
araJ	('araJ')	'araJ'	((((((('araJ')))))))
arcD	('arcD')	'arcD'	((((((('arcD')))))))
arg_full	('arg1' & 'arg2' & 'arg3' & 'arg4')	'arg_full'	('arg1' & 'arg2' & 'arg3' & 'arg4')
arg_key	('arg1')	'arg_key'	('arg1')
argT	('argT')	'argT'	((((((('argT')))))))
arnE	('arnE')	'arnE'	((((((('arnE')))))))
arsB-1	('arsB1')	'arsB-1'	('arsB1')
arsB-2	('arsB2')	'arsB-2'	('arsB2')
art-1_full	('artJ' & 'artI' & 'artM' & 'artQ1' & 'artP1')	'art-1_full'	('artJ' & 'artI' & 'artM' & 'artQ1' & 'artP1')
art-1_partial	('artJ' | 'artI')	'art-1_partial'	('artJ' | 'artI')
art-2_full	('artQ2' & 'artP2' & 'artR')	'art-2_full'	('artQ2' & 'artP2' & 'artR')
art-2_key	('artP2')	'art-2_key'	('artP2')
asc_full	('ascEIIB' & 'ascEIIC')	'asc_full'	('ascEIIB' & 'ascEIIC')
asc_partial	('ascEIIB' | 'ascEIIC')	'asc_partial'	('ascEIIB' | 'ascEIIC')
atoE_key	('atoE')	'atoE_key'	('atoE')
att_full	('attA1' & 'attB' & 'attC' & 'attA2')	'att_full'	('attA1' & 'attB' & 'attC' & 'attA2')
att_key	('attC')	'att_key'	('attC')
bce_full	('bceA' & 'bceB')	'bce_full'	('bceA' & 'bceB')
bce_key	('bceB')	'bce_key'	('bceB')
bcr_full	('bcrA' & 'bcrB')	'bcr_full'	('bcrA' & 'bcrB')
bcr_key	('bcrB')	'bcr_key'	('bcrB')
benE	('benE')	'benE'	((((((('benE')))))))
betL	('betL')	'betL'	((((((('betL')))))))
betT	('betT')	'betT'	((((((('betT')))))))
bgl_full	('bglEIIA' & 'bglEIIB' & 'bglEIIC')	'bgl_full'	('bglEIIA' & 'bglEIIB' & 'bglEIIC')
bgl_partial	('bglEIIA' | 'bglEIIB' | 'bglEIIC')	'bgl_partial'	('bglEIIA' | 'bglEIIB' | 'bglEIIC')
bglH	('bglH')	'bglH'	((((((('bglH')))))))
bgt_full	('bgtB' & 'bgtA')	'bgt_full'	('bgtB' & 'bgtA')
bgt_key	('bgtB')	'bgt_key'	('bgtB')
bica	('bica')	'bica'	((((((('bica')))))))
bio-1_full	('bioY' & 'bioN' & 'bioM')	'bio-1_full'	('bioY' & 'bioN' & 'bioM')
bio-1_key	('bioY')	'bio-1_key'	('bioY')
bio-2_full	('bioY' & 'ecfT' & ('ecfA1' | 'ecfA2'))	'bio-2_full'	('bioY' & 'ecfT' & ((((((('ecfA1')))))) | 'ecfA2'))
bio-2_key	('bioY')	'bio-2_key'	('bioY')
blpA	('blpA')	'blpA'	((((((('blpA')))))))
bpeEF-oprC_full	('bpeE' & 'bpeF' & 'oprC')	'bpeEF-oprC_full'	('bpeE' & 'bpeF' & 'oprC')
bpeEF-oprC_partial	('bpeE' | 'bpeF' | 'oprC')	'bpeEF-oprC_partial'	('bpeE' | 'bpeF' | 'oprC')
bra_full	('braD' & 'braE')	'bra_full'	('braD' & 'braE')
bra_partial	('braD' | 'braE')	'bra_partial'	('braD' | 'braE')
btu_full	('btuC' & 'btuD' & 'btuF')	'btu_full'	('btuC' & 'btuD' & 'btuF')
btu_key	('btuF')	'btu_key'	('btuF')
btuB	('btuB')	'btuB'	((((((('btuB')))))))
bxl_full	('bxlE' & 'bxlF' & 'bxlG')	'bxl_full'	('bxlE' & 'bxlF' & 'bxlG')
bxl_key	('bxlE')	'bxl_key'	('bxlE')
cbi-1_full	('cbiM' & 'cbiN' & 'cbiO' & 'cbiQ')	'cbi-1_full'	('cbiM' & 'cbiN' & 'cbiO' & 'cbiQ')
cbi-1_partial	('cbiM' | 'cbiN' | 'cbiQ')	'cbi-1_partial'	('cbiM' | 'cbiN' | 'cbiQ')
cbi-2_full	('cbiK' & ('cbiN' | 'cbiL') & 'cbiM' & 'cbiQ' & 'cbiO')	'cbi-2_full'	('cbiK' & ('cbiN' | 'cbiL') & 'cbiM' & 'cbiQ' & 'cbiO')
cbi-2_key	('cbiK')	'cbi-2_key'	('cbiK')
ccm-1_full	('ccmD' & 'ccmB' & 'ccmC' & 'ccmA')	'ccm-1_full'	('ccmD' & 'ccmB' & 'ccmC' & 'ccmA')
ccm-1_partial	('ccmD' | 'ccmB' | 'ccmC' | 'ccmA')	'ccm-1_partial'	('ccmD' | 'ccmB' | 'ccmC' | 'ccmA')
ceb_full	('cebE' & 'cebF' & 'cebG' & 'msmX')	'ceb_full'	('cebE' & 'cebF' & 'cebG' & 'msmX')
ceb_key	('cebE')	'ceb_key'	('cebE')
cel_full	('celEIIA' & 'celEIIB' & 'celEIIC')	'cel_full'	('celEIIA' & 'celEIIB' & 'celEIIC')
cel_partial	('celEIIA' | 'celEIIB' | 'celEIIC')	'cel_partial'	('celEIIA' | 'celEIIB' | 'celEIIC')
cfrA	('cfrA')	'cfrA'	((((((('cfrA')))))))
chaA	('chaA')	'chaA'	((((((('chaA')))))))
chi_full	('chiE' & 'chiF' & 'chiG')	'chi_full'	('chiE' & 'chiF' & 'chiG')
chi_key	('chiE')	'chi_key'	('chiE')
chrA	('chrA')	'chrA'	((((((('chrA')))))))
citA	('citA')	'citA'	((((((('citA')))))))
citT	('citT')	'citT'	((((((('citT')))))))
cmlA	('cmlA')	'cmlA'	((((((('cmlA')))))))
cmp_full	('cmpB' & 'cmpA' & 'cmpC' & 'cmpD')	'cmp_full'	('cmpB' & 'cmpA' & 'cmpC' & 'cmpD')
cmp_key	('cmpA')	'cmp_key'	('cmpA')
codB	('codB')	'codB'	((((((('codB')))))))
corA	('corA')	'corA'	((((((('corA')))))))
cusA	('cusA')	'cusA'	((((((('cusA')))))))
cusC	('cusC')	'cusC'	((((((('cusC')))))))
cycA	('cycA')	'cycA'	((((((('cycA')))))))
cyd_full	('cydC' & 'cydD' & 'cydCD')	'cyd_full'	('cydC' & 'cydD' & 'cydCD')
cyd_partial	('cydC' | 'cydD' | 'cydCD')	'cyd_partial'	('cydC' | 'cydD' | 'cydCD')
cys_full	('sbp' & 'cysU' & 'cysA' & 'cysW' & 'cysP')	'cys_full'	('sbp' & 'cysU' & 'cysA' & 'cysW' & 'cysP')
cys_partial	('sbp' | 'cysP')	'cys_partial'	('sbp' | 'cysP')
czcA	('czcA')	'czcA'	((((((('czcA')))))))
czcC	('czcC')	'czcC'	((((((('czcC')))))))
czcD	('czcD')	'czcD'	((((((('czcD')))))))
das_full	('dasC' & 'dasB' & 'dasA')	'das_full'	('dasC' & 'dasB' & 'dasA')
das_key	('dasA')	'das_key'	('dasA')
dct_full	('dctQ' & 'dctP' & 'dctM')	'dct_full'	('dctQ' & 'dctP' & 'dctM')
dct_key	('dctP')	'dct_key'	('dctP')
dctA	('dctA')	'dctA'	((((((('dctA')))))))
dcuA	('dcuA')	'dcuA'	((((((('dcuA')))))))
dcuB	('dcuB')	'dcuB'	((((((('dcuB')))))))
dcuC	('dcuC')	'dcuC'	((((((('dcuC')))))))
dev_full	('devC' & 'devA' & 'devB' & 'hgdD')	'dev_full'	('devC' & 'devA' & 'devB' & 'hgdD')
dev_partial	('devC' | 'devA' | 'devB' | 'hgdD')	'dev_partial'	('devC' | 'devA' | 'devB' | 'hgdD')
dga_full	('dgaEIIA' & 'dgaEIIB' & 'dgaEIIC' & 'dgaEIID')	'dga_full'	('dgaEIIA' & 'dgaEIIB' & 'dgaEIIC' & 'dgaEIID')
dga_partial	('dgaEIIA' | 'dgaEIIB' | 'dgaEIIC' & 'dgaEIID')	'dga_partial'	('dgaEIIA' | 'dgaEIIB' | 'dgaEIIC' & 'dgaEIID')
dgl_full	('dglEIIA' & 'dglEIIB' & 'dglEIIC')	'dgl_full'	('dglEIIA' & 'dglEIIB' & 'dglEIIC')
dgl_partial	('dglEIIA' | 'dglEIIB' | 'dglEIIC')	'dgl_partial'	('dglEIIA' | 'dglEIIB' | 'dglEIIC')
dltB	('dltB')	'dltB'	((((((('dltB')))))))
dpp-1_full	('dppA1' & 'dppB1' & 'dppC1' & 'dppD1' & 'dppF1')	'dpp-1_full'	('dppA1' & 'dppB1' & 'dppC1' & 'dppD1' & 'dppF1')
dpp-1_key	('dppA1')	'dpp-1_key'	('dppA1')
dpp-2_full	('dppB2' & 'dppC2' & 'dppD2' & 'dppE')	'dpp-2_full'	('dppB2' & 'dppC2' & 'dppD2' & 'dppE')
dpp-2_key	('dppE')	'dpp-2_key'	('dppE')
dsdX	('dsdX')	'dsdX'	((((((('dsdX')))))))
eamA	('eamA')	'eamA'	((((((('eamA')))))))
eamB	('eamB')	'eamB'	((((((('eamB')))))))
ebr-1_full	('ebrA' & 'ebrB')	'ebr-1_full'	('ebrA' & 'ebrB')
ebr-1_partial	('ebrA' | 'ebrB')	'ebr-1_partial'	('ebrA' | 'ebrB')
ebr-2	('ebr')	'ebr-2'	('ebr')
ecfA1	('ecfA1')	'ecfA1'	((((((('ecfA1')))))))
eexD_key	('eexD')	'eexD_key'	('eexD')
efeB	('efeB')	'efeB'	((((((('efeB')))))))
efeO	('efeO')	'efeO'	((((((('efeO')))))))
emrK	('emrK')	'emrK'	((((((('emrK')))))))
emrY	('emrY')	'emrY'	((((((('emrY')))))))
entS	('entS')	'entS'	((((((('entS')))))))
eps_full	('epsE' & 'epsF')	'eps_full'	('epsE' & 'epsF')
eps_partial	('epsE' | 'epsF')	'eps_partial'	('epsE' | 'epsF')
ery_full	('eryG' & 'eryF' & 'eryE')	'ery_full'	('eryG' & 'eryF' & 'eryE')
ery_key	('eryG')	'ery_key'	('eryG')
exb_full	('exbB' & 'exbD')	'exb_full'	('exbB' & 'exbD')
exb_key	('exbB' | 'exbD')	'exb_key'	('exbB' | 'exbD')
exbD_full	('exbB' | 'exbD')	'exbD_full'	('exbB' | 'exbD')
exbD_key	('exbB' | 'exbD')	'exbD_key'	('exbB' | 'exbD')
exoF	('exoF')	'exoF'	((((((('exoF')))))))
exoT	('exoT')	'exoT'	((((((('exoT')))))))
fadL	('fadL')	'fadL'	((((((('fadL')))))))
fdhC	('fdhC')	'fdhC'	((((((('fdhC')))))))
fec_full	('fecE' & 'fecB' & 'fecD' & 'fecC')	'fec_full'	('fecE' & 'fecB' & 'fecD' & 'fecC')
fec_key	('fecB')	'fec_key'	('fecB')
fecA	('fecA')	'fecA'	((((((('fecA')))))))
fep_full	('fepC' & 'fepG' & 'fepD' & 'fepB')	'fep_full'	('fepC' & 'fepG' & 'fepD' & 'fepB')
fep_key	('fepB')	'fep_key'	('fepB')
fepA	('fepA')	'fepA'	((((((('fepA')))))))
fev_full	('fevA' & 'fevP' & 'fevS')	'fev_full'	('fevA' & 'fevP' & 'fevS')
fev_key	('fevS')	'fev_key'	('fevS')
fhu_full	('fhuC' & 'fhuB' & 'fhuD')	'fhu_full'	('fhuC' & 'fhuB' & 'fhuD')
fhu_key	('fhuD')	'fhu_key'	('fhuD')
fieF	('fieF')	'fieF'	((((((('fieF')))))))
fiu	('fiu')	'fiu'	((((((('fiu')))))))
flq_full	('flqA' & 'flqB' & 'flqC')	'flq_full'	('flqA' & 'flqB' & 'flqC')
flq_partial	('flqA' | 'flqB' | 'flqC')	'flq_partial'	('flqA' | 'flqB' | 'flqC')
focA	('focA')	'focA'	((((((('focA')))))))
focB	('focB')	'focB'	((((((('focB')))))))
fpvA	('fpvA')	'fpvA'	((((((('fpvA')))))))
frc_full	('frcA' & 'frcB' & 'frcC')	'frc_full'	('frcA' & 'frcB' & 'frcC')
frc_key	('frcB')	'frc_key'	('frcB')
fru1_full	('fru1EIIA' & 'fru1EIIB' & 'fru1EIIC' & 'levG')	'fru1_full'	('fru1EIIA' & 'fru1EIIB' & 'fru1EIIC' & 'levG')
fru1_partial	('fru1EIIA' | 'fru1EIIB' | 'fru1EIIC' & 'levG')	'fru1_partial'	('fru1EIIA' | 'fru1EIIB' | 'fru1EIIC' & 'levG')
fru2_full	('fru2EIIA' & 'fru2EIIB' & 'fru2EIIC')	'fru2_full'	('fru2EIIA' & 'fru2EIIB' & 'fru2EIIC')
fru2_partial	('fru2EIIA' | 'fru2EIIB' | 'fru2EIIC')	'fru2_partial'	('fru2EIIA' | 'fru2EIIB' | 'fru2EIIC')
ftrA	('ftrA')	'ftrA'	((((((('ftrA')))))))
gadC	('gadC')	'gadC'	((((((('gadC')))))))
gal_full	('galEIIA' & 'galEIIB' & 'galEIIC')	'gal_full'	('galEIIA' & 'galEIIB' & 'galEIIC')
gal_partial	('galEIIA' | 'galEIIB' | 'galEIIC')	'gal_partial'	('galEIIA' | 'galEIIB' | 'galEIIC')
galP	('galP')	'galP'	((((((('galP')))))))
gam_full	('gamEIIB' & 'gamEIIC' & 'gamEIID')	'gam_full'	('gamEIIB' & 'gamEIIC' & 'gamEIID')
gam_partial	('gamEIIB' | 'gamEIIC' | 'gamEIID')	'gam_partial'	('gamEIIB' | 'gamEIIC' | 'gamEIID')
gan_full	('ganO' & 'ganP' & 'ganQ' & ('malK' | 'msmX'))	'gan_full'	('ganO' & 'ganP' & 'ganQ' & ('malK' | 'msmX'))
gan_key	('ganO')	'gan_key'	('ganO')
gat_full	('gatEIIA' & 'gatEIIB' & 'gatEIIC')	'gat_full'	('gatEIIA' & 'gatEIIB' & 'gatEIIC')
gat_partial	('gatEIIA' | 'gatEIIB' | 'gatEIIC')	'gat_partial'	('gatEIIA' | 'gatEIIB' | 'gatEIIC')
gesB	('gesB')	'gesB'	((((((('gesB')))))))
gfr_full	('gfrEIIA' & 'gfrEIIB' & 'gfrEIIC' & 'gfrEIID')	'gfr_full'	('gfrEIIA' & 'gfrEIIB' & 'gfrEIIC' & 'gfrEIID')
gfr_partial	('gfrEIIA' | 'gfrEIIB' | 'gfrEIIC' & 'gfrEIID')	'gfr_partial'	('gfrEIIA' | 'gfrEIIB' | 'gfrEIIC' & 'gfrEIID')
ggu_full	('gguA' & 'gguP' & 'gguS')	'ggu_full'	('gguA' & 'gguP' & 'gguS')
ggu_key	('gguS')	'ggu_key'	('gguS')
glc_full	('glcP' & 'glcP1' & 'glcS' & 'glcA')	'glc_full'	('glcP' & 'glcP1' & 'glcS' & 'glcA')
glc_key	('glcS')	'glc_key'	('glcS')
glc-1_full	('glc1EIIA' & 'glc1EIIB' & 'glc1EIIC')	'glc-1_full'	('glc1EIIA' & 'glc1EIIB' & 'glc1EIIC')
glc-1_partial	('glc1EIIA' | 'glc1EIIB' | 'glc1EIIC')	'glc-1_partial'	('glc1EIIA' | 'glc1EIIB' | 'glc1EIIC')
glc-2_full	('glc2EIIA' & 'glc2EIIB' & 'glc2EIIC')	'glc-2_full'	('glc2EIIA' & 'glc2EIIB' & 'glc2EIIC')
glc-2_partial	('glc2EIIA' | 'glc2EIIB' | 'glc2EIIC')	'glc-2_partial'	('glc2EIIA' | 'glc2EIIB' | 'glc2EIIC')
glcT1	('glcT1')	'glcT1'	((((((('glcT1')))))))
glcU	('glcU')	'glcU'	((((((('glcU')))))))
glf	('glf')	'glf'	((((((('glf')))))))
gln_full	('glnH' & 'glnP' & 'glnQ')	'gln_full'	('glnH' & 'glnP' & 'glnQ')
gln_key	('glnH')	'gln_key'	('glnH')
glp_full	('glpP' & 'glpQ' & 'glpV' & 'glpS' & 'glpT')	'glp_full'	('glpP' & 'glpQ' & 'glpV' & 'glpS' & 'glpT')
glp_key	('glpV')	'glp_key'	('glpV')
glpF	('glpF')	'glpF'	((((((('glpF')))))))
glt_full	('gltI' & 'gltK' & 'gltJ' & 'gltL')	'glt_full'	('gltI' & 'gltK' & 'gltJ' & 'gltL')
glt_key	('gltI')	'glt_key'	('gltI')
gltP	('gltP')	'gltP'	((((((('gltP')))))))
glu_full	('gluB' & 'gluC' & 'gluD' & 'gluA')	'glu_full'	('gluB' & 'gluC' & 'gluD' & 'gluA')
glu_key	('gluB')	'glu_key'	('gluB')
glucP	('glucP')	'glucP'	((((((('glucP')))))))
glv_full	('glvEIIB' & 'glvEIIC')	'glv_full'	('glvEIIB' & 'glvEIIC')
glv_partial	('glvEIIB' | 'glvEIIC')	'glv_partial'	('glvEIIB' | 'glvEIIC')
glycA	('glcA')	'glycA'	('glcA')
gntP	('gntP')	'gntP'	((((((('gntP')))))))
gntT	('gntT')	'gntT'	((((((('gntT')))))))
gntU	('gntU')	'gntU'	((((((('gntU')))))))
gsi_full	('gsiC' & 'gsiD' & 'gsiB' & 'gsiA')	'gsi_full'	('gsiC' & 'gsiD' & 'gsiB' & 'gsiA')
gsi_key	('gsiB')	'gsi_key'	('gsiB')
gts_full	('gtsA' & 'gtsB' & 'gtsC' & 'msmX')	'gts_full'	('gtsA' & 'gtsB' & 'gtsC' & 'msmX')
gts_key	('gtsA')	'gts_key'	('gtsA')
gut_full	('gutEIIA' & 'gutEIIB' & 'gutEIIC')	'gut_full'	('gutEIIA' & 'gutEIIB' & 'gutEIIC')
gut_partial	('gutEIIA' | 'gutEIIB' | 'gutEIIC')	'gut_partial'	('gutEIIA' | 'gutEIIB' | 'gutEIIC')
gutA	('gutA')	'gutA'	((((((('gutA')))))))
hasA	('hasA')	'hasA'	((((((('hasA')))))))
hasR	('hasR')	'hasR'	((((((('hasR')))))))
hcaT	('hcaT')	'hcaT'	((((((('hcaT')))))))
his_full	('hisJ' & 'hisP' & 'hisQ' & 'hisM')	'his_full'	('hisJ' & 'hisP' & 'hisQ' & 'hisM')
his_key	('hisJ')	'his_key'	('hisJ')
hpt	('hpt')	'hpt'	((((((('hpt')))))))
hrt_full	('hrtA' & 'hrtB')	'hrt_full'	('hrtA' & 'hrtB')
hrt_key	('hrtB')	'hrt_key'	('hrtB')
hutM	('hutM')	'hutM'	((((((('hutM')))))))
hutT	('hutT')	'hutT'	((((((('hutT')))))))
hxt	('hxt')	'hxt'	((((((('hxt')))))))
idnT	('idnT')	'idnT'	((((((('idnT')))))))
ino_full	('inoF' & 'inoG' & 'inoE' & 'inoK')	'ino_full'	('inoF' & 'inoG' & 'inoE' & 'inoK')
ino_key	('inoE')	'ino_key'	('inoE')
iolF	('iolF')	'iolF'	((((((('iolF')))))))
itsp-1_full	('ibpA1' & 'iatP1' & 'iatA1')	'itsp-1_full'	('ibpA1' & 'iatP1' & 'iatA1')
itsp-1_key	('ibpA1')	'itsp-1_key'	('ibpA1')
itsp-2_full	('iatP2' & 'iatA2' & 'ibpA2')	'itsp-2_full'	('iatP2' & 'iatA2' & 'ibpA2')
itsp-2_key	('ibpA2')	'itsp-2_key'	('ibpA2')
kdgM	('kdgM')	'kdgM'	((((((('kdgM')))))))
kdgT	('kdgT')	'kdgT'	((((((('kdgT')))))))
kgtP	('kgtP')	'kgtP'	((((((('kgtP')))))))
kps_full	('kpsM' & 'kpsE' & 'kpsT')	'kps_full'	('kpsM' & 'kpsE' & 'kpsT')
kps_key	('kpsE' | 'kpsT')	'kps_key'	('kpsE' | 'kpsT')
kup	('kup')	'kup'	((((((('kup')))))))
lac-1_full	('lacEIIA' & 'lacEIIB' & 'lacEIIC')	'lac-1_full'	('lacEIIA' & 'lacEIIB' & 'lacEIIC')
lac-1_partial	('lacEIIA' | 'lacEIIB' | 'lacEIIC')	'lac-1_partial'	('lacEIIA' | 'lacEIIB' | 'lacEIIC')
lac-2_full	('lacE' & 'lacF' & 'lacG' & 'lacK')	'lac-2_full'	('lacE' & 'lacF' & 'lacG' & 'lacK')
lac-2_key	('lacE')	'lac-2_key'	('lacE')
lacS	('lacS')	'lacS'	((((((('lacS')))))))
lacY	('lacY')	'lacY'	((((((('lacY')))))))
lamB	('lamB')	'lamB'	((((((('lamB')))))))
lctB	('lctB')	'lctB'	((((((('lctB')))))))
lctP-1	('lctP1')	'lctP-1'	('lctP1')
lctP-2	('lctP2')	'lctP-2'	('lctP2')
leuE	('leuE')	'leuE'	((((((('leuE')))))))
lhp_full	('lhpM' & 'lhpN' & 'lhpO' & 'lhpP')	'lhp_full'	('lhpM' & 'lhpN' & 'lhpO' & 'lhpP')
lhp_key	('lhpP')	'lhp_key'	('lhpP')
liv_full	('livG' & 'livF' & 'livH' & 'livM' & 'livK')	'liv_full'	('livG' & 'livF' & 'livH' & 'livM' & 'livK')
liv_key	('livK')	'liv_key'	('livK')
lol_and	('lolD' & 'lolC_E')	'lol_and'	('lolD' & 'lolC_E')
lol_or	('lolD' | 'lolC_E')	'lol_or'	('lolD' | 'lolC_E')
lpiT	('lplT')	'lpiT'	('lplT')
lpl_full	('lplC' & 'lplB' & 'lplA')	'lpl_full'	('lplC' & 'lplB' & 'lplA')
lpl_key	('lplA')	'lpl_key'	('lplA')
lpse_full	('lpseA' & 'lpseP')	'lpse_full'	('lpseA' & 'lpseP')
lpse_key	('lpseP')	'lpse_key'	('lpseP')
lpt_and	('lptB' & 'lptF' & 'lptG')	'lpt_and'	('lptB' & 'lptF' & 'lptG')
lpt_or	('lptB' | 'lptF' | 'lptG')	'lpt_or'	('lptB' | 'lptF' | 'lptG')
lptA	('lptA')	'lptA'	((((((('lptA')))))))
lptC_and	('lptC' & 'lptD' & 'lptG')	'lptC_and'	('lptC' & 'lptD' & 'lptG')
lptC_or	('lptC' | 'lptD' | 'lptG')	'lptC_or'	('lptC' | 'lptD' | 'lptG')
lptD_and	('lptC' & 'lptD' & 'lptG')	'lptD_and'	('lptC' & 'lptD' & 'lptG')
lptD_or	('lptC' | 'lptD' | 'lptG')	'lptD_or'	('lptC' | 'lptD' | 'lptG')
lptE	('lptE')	'lptE'	((((((('lptE')))))))
lys_full	('lysX1' & 'lysX2' & 'lysY')	'lys_full'	('lysX1' & 'lysX2' & 'lysY')
lys_key	('lysX1')	'lys_key'	('lysX1')
lysE	('lysE')	'lysE'	((((((('lysE')))))))
lysP	('lysP')	'lysP'	((((((('lysP')))))))
macA_full	('macA' & 'macB')	'macA_full'	('macA' & 'macB')
macA_partial	('macA' | 'macB')	'macA_partial'	('macA' | 'macB')
macB_full	('macA' & 'macB')	'macB_full'	('macA' & 'macB')
macB_partial	('macA' | 'macB')	'macB_partial'	('macA' | 'macB')
maeN	('maeN')	'maeN'	((((((('maeN')))))))
mal-1_full	('malEIIB' & 'malEIIC')	'mal-1_full'	('malEIIB' & 'malEIIC')
mal-1_partial	('malEIIB' | 'malEIIC')	'mal-1_partial'	('malEIIB' | 'malEIIC')
mal-2_full	('malE' & 'malF' & 'malG' & ('malK' | 'msmX'))	'mal-2_full'	('malE' & 'malF' & 'malG' & ('malK' | 'msmX'))
mal-2_key	('malE')	'mal-2_key'	('malE')
malglc_full	('malglcEIIB' & 'malglcEIIC')	'malglc_full'	('malglcEIIB' & 'malglcEIIC')
malglc_partial	('malglcEIIB' | 'malglcEIIC')	'malglc_partial'	('malglcEIIB' | 'malglcEIIC')
malY	('malY')	'malY'	((((((('malY')))))))
man_full	('manEIIA' & 'manEIIB' & 'manEIIC' & 'manEIID')	'man_full'	('manEIIA' & 'manEIIB' & 'manEIIC' & 'manEIID')
man_partial	('manEIIA' | 'manEIIB' | 'manEIIC' & 'manEIID')	'man_partial'	('manEIIA' | 'manEIIB' | 'manEIIC' & 'manEIID')
marC	('marC')	'marC'	((((((('marC')))))))
mdcF	('mdcF')	'mdcF'	((((((('mdcF')))))))
mdt_full	('mdtB' & 'mdtC')	'mdt_full'	('mdtB' & 'mdtC')
mdt_partial	('mdtB' | 'mdtC')	'mdt_partial'	('mdtB' | 'mdtC')
mdtD	('mdtD')	'mdtD'	((((((('mdtD')))))))
mdtF	('mdtF')	'mdtF'	((((((('mdtF')))))))
mdtO	('mdtO')	'mdtO'	((((((('mdtO')))))))
mdtP	('mdtP')	'mdtP'	((((((('mdtP')))))))
melB	('melB')	'melB'	((((((('melB')))))))
mer_full	('merP' & 'merT')	'mer_full'	('merP' & 'merT')
mer_partial	('merP' | 'merT')	'mer_partial'	('merP' | 'merT')
merC	('merC')	'merC'	((((((('merC')))))))
merE	('merE')	'merE'	((((((('merE')))))))
met_full	('metN' & 'metI' & 'metQ')	'met_full'	('metN' & 'metI' & 'metQ')
met_key	('metQ')	'met_key'	('metQ')
mfs.cp	('mfs.cp')	'mfs.cp'	((((((('mfs.cp')))))))
mfs.set	('mfs.set')	'mfs.set'	((((((('mfs.set')))))))
mgl_full	('mglA' & 'mglB' & 'mglC')	'mgl_full'	('mglA' & 'mglB' & 'mglC')
mgl_key	('mglB')	'mgl_key'	('mglB')
mgtE	('mgtE')	'mgtE'	((((((('mgtE')))))))
mhpT	('mhpT')	'mhpT'	((((((('mhpT')))))))
mla-1_full	('mlaB' & 'mlaC' & 'mlaF' & 'mlaE' & 'mlaD')	'mla-1_full'	('mlaB' & 'mlaC' & 'mlaF' & 'mlaE' & 'mlaD')
mla-1_partial	('mlaB' | 'mlaC' | 'mlaF' | 'mlaE' | 'mlaD')	'mla-1_partial'	('mlaB' | 'mlaC' | 'mlaF' | 'mlaE' | 'mlaD')
mla-2	('mlaA')	'mla-2'	('mlaA')
mleP	('mleP')	'mleP'	((((((('mleP')))))))
mmpL10	('mmpL10')	'mmpL10'	((((((('mmpL10')))))))
mmpL11	('mmpL11')	'mmpL11'	((((((('mmpL11')))))))
mmr	('mmr')	'mmr'	((((((('mmr')))))))
mmuP	('mmuP')	'mmuP'	((((((('mmuP')))))))
mn_full	('mnA' & 'mnP' & 'mnS')	'mn_full'	('mnA' & 'mnP' & 'mnS')
mn_key	('mnS')	'mn_key'	('mnS')
mng_full	('mngEIIA' & 'mngEIIB' & 'mngEIIC')	'mng_full'	('mngEIIA' & 'mngEIIB' & 'mngEIIC')
mng_partial	('mngEIIA' | 'mngEIIB' | 'mngEIIC')	'mng_partial'	('mngEIIA' | 'mngEIIB' | 'mngEIIC')
mnh_full	('mnhB' & 'mnhC' & 'mnhE' & 'mnhA' & 'mnhF' & 'mnhG' & 'mnhD')	'mnh_full'	('mnhB' & 'mnhC' & 'mnhE' & 'mnhA' & 'mnhF' & 'mnhG' & 'mnhD')
mnh_partial	('mnhB' | 'mnhC' | 'mnhE' | 'mnhA' | 'mnhF' | 'mnhG' | 'mnhD')	'mnh_partial'	('mnhB' | 'mnhC' | 'mnhE' | 'mnhA' | 'mnhF' | 'mnhG' | 'mnhD')
mnt-1_full	('mntA1' & 'mntB1' & 'mntC1')	'mnt-1_full'	('mntA1' & 'mntB1' & 'mntC1')
mnt-1_key	('mntC1')	'mnt-1_key'	('mntC1')
mnt-2_full	('mntA2' & 'mntB2' & 'mntC2')	'mnt-2_full'	('mntA2' & 'mntB2' & 'mntC2')
mnt-2_key	('mntC2')	'mnt-2_key'	('mntC2')
mntH	('mntH')	'mntH'	((((((('mntH')))))))
mntP_key	('mntP')	'mntP_key'	('mntP')
mod_full	('modF' & 'modC' & 'modB' & 'modA')	'mod_full'	('modF' & 'modC' & 'modB' & 'modA')
mod_key	('modA')	'mod_key'	('modA')
motA	('motA')	'motA'	((((((('motA')))))))
motB	('motB')	'motB'	((((((('motB')))))))
msbA	('msbA')	'msbA'	((((((('msbA')))))))
mscL	('mscL')	'mscL'	((((((('mscL')))))))
msm-1_full	('msmE1' & 'msmF1' & 'msmG1' & 'msmX')	'msm-1_full'	('msmE1' & 'msmF1' & 'msmG1' & 'msmX')
msm-1_key	('msmE1')	'msm-1_key'	('msmE1')
msm-2_full	('msmE2' & 'msmF2' & 'msmG2' & 'msmX')	'msm-2_full'	('msmE2' & 'msmF2' & 'msmG2' & 'msmX')
msm-2_key	('msmE2')	'msm-2_key'	('msmE2')
mthK	('mthK')	'mthK'	((((((('mthK')))))))
mtl-1_full	('mtlEIIA' & 'mtlEIIB' & 'mtlEIIC')	'mtl-1_full'	('mtlEIIA' & 'mtlEIIB' & 'mtlEIIC')
mtl-1_partial	('mtlEIIA' | 'mtlEIIB' | 'mtlEIIC')	'mtl-1_partial'	('mtlEIIA' | 'mtlEIIB' | 'mtlEIIC')
mtl-2_full	('mtlE' & 'mtlF' & 'mtlG' & ('malK' | 'msmX'))	'mtl-2_full'	('mtlE' & 'mtlF' & 'mtlG' & ('malK' | 'msmX'))
mtl-2_partial	('mtlE')	'mtl-2_partial'	('mtlE')
mtr-2	('mtr')	'mtr-2'	('mtr')
mtrD	('mtrD')	'mtrD'	((((((('mtrD')))))))
mts_full	('mtsA' & 'mtsB' & 'mtsC')	'mts_full'	('mtsA' & 'mtsB' & 'mtsC')
mts_key	('mtsA')	'mts_key'	('mtsA')
mur_full	('murEIIB' & 'murEIIC')	'mur_full'	('murEIIB' & 'murEIIC')
mur_partial	('murEIIB' | 'murEIIC')	'mur_partial'	('murEIIB' | 'murEIIC')
nag_full	('nagEIIA' & 'nagEIIB' & 'nagEIIC')	'nag_full'	('nagEIIA' & 'nagEIIB' & 'nagEIIC')
nag_partial	('nagEIIA' | 'nagEIIB' | 'nagEIIC')	'nag_partial'	('nagEIIA' | 'nagEIIB' | 'nagEIIC')
nat-1_full	('natA' & 'natB')	'nat-1_full'	('natA' & 'natB')
nat-1_key	('natB')	'nat-1_key'	('natB')
nat-2_full	('natB1' & 'natC' & 'natD1' & 'natA1' & 'natE')	'nat-2_full'	('natB1' & 'natC' & 'natD1' & 'natA1' & 'natE')
nat-2_key	('natB1')	'nat-2_key'	('natB1')
nepI	('nepI')	'nepI'	((((((('nepI')))))))
ngc_full	('ngcE' & 'ngcF' & 'ngcG')	'ngc_full'	('ngcE' & 'ngcF' & 'ngcG')
ngc_key	('ngcE')	'ngc_key'	('ngcE')
nhaA	('nhaA')	'nhaA'	((((((('nhaA')))))))
nhaB	('nhaB')	'nhaB'	((((((('nhaB')))))))
nhaC	('nhaC')	'nhaC'	((((((('nhaC')))))))
niaX	('niaX')	'niaX'	((((((('niaX')))))))
nik_full	('nikA' & 'nikB' & 'nikC' & 'nikD' & 'nikE')	'nik_full'	('nikA' & 'nikB' & 'nikC' & 'nikD' & 'nikE')
nik_key	('nikA')	'nik_key'	('nikA')
nirC	('nirC')	'nirC'	((((((('nirC')))))))
nis_full	('nisG' & 'nisE' & 'nisF')	'nis_full'	('nisG' & 'nisE' & 'nisF')
nis_partial	('nisG' | 'nisE' | 'nisF')	'nis_partial'	('nisG' | 'nisE' | 'nisF')
nisA	('nisA')	'nisA'	((((((('nisA')))))))
nitregulatory_full	('ptsP' & 'ptsO' & 'ntrEIIA')	'nitregulatory_full'	('ptsP' & 'ptsO' & 'ntrEIIA')
nitregulatory_partial	('ptsP' & 'ptsO' | 'ntrEIIA')	'nitregulatory_partial'	('ptsP' & 'ptsO' | 'ntrEIIA')
nixA	('nixA')	'nixA'	((((((('nixA')))))))
nod_full	('nodI' & 'nodJ')	'nod_full'	('nodI' & 'nodJ')
nod_partial	('nodI' | 'nodJ')	'nod_partial'	('nodI' | 'nodJ')
nos_full	('nosF' & 'nosY')	'nos_full'	('nosF' & 'nosY')
nos_key	('nosY')	'nos_key'	('nosY')
nrsA	('nrsA')	'nrsA'	((((((('nrsA')))))))
nrt_full	('nrtD' & 'nrtC' & 'nrtB' & 'nrtA')	'nrt_full'	('nrtD' & 'nrtC' & 'nrtB' & 'nrtA')
nrt_key	('nrtA')	'nrt_key'	('nrtA')
nuk_full	('nukE' & 'nukF' & 'nukG')	'nuk_full'	('nukE' & 'nukF' & 'nukG')
nuk_partial	('nukE' | 'nukF' | 'nukG')	'nuk_partial'	('nukE' | 'nukF' | 'nukG')
nupC	('nupC')	'nupC'	((((((('nupC')))))))
nupG	('nupG')	'nupG'	((((((('nupG')))))))
nupX	('nupX')	'nupX'	((((((('nupX')))))))
occ_full	('occP' & 'occQ' & 'occM' & 'occT')	'occ_full'	('occP' & 'occQ' & 'occM' & 'occT')
occ_key	('occT')	'occ_key'	('occT')
oleC_full	('oleC4' & 'oleC5')	'oleC_full'	('oleC4' & 'oleC5')
oleC_key	('oleC5')	'oleC_key'	('oleC5')
ompA	('ompA')	'ompA'	((((((('ompA')))))))
opmD_key	('opmD')	'opmD_key'	('opmD')
opmE	('opmE')	'opmE'	((((((('opmE')))))))
opp-1_full	('oppA1' & 'oppB1' & 'oppC1' & 'oppD1' & 'oppF1')	'opp-1_full'	('oppA1' & 'oppB1' & 'oppC1' & 'oppD1' & 'oppF1')
opp-1_key	('oppA1')	'opp-1_key'	('oppA1')
oprB	('oprB')	'oprB'	((((((('oprB')))))))
oprD	('oprD')	'oprD'	((((((('oprD')))))))
oprN	('oprN')	'oprN'	((((((('oprN')))))))
oprO_P	('oprO_P')	'oprO_P'	((((((('oprO_P')))))))
opu_and	('opuBD' & 'opuA' & 'opuC')	'opu_and'	('opuBD' & 'opuA' & 'opuC')
opu_key	('opuC')	'opu_key'	('opuC')
oqxB	('oqxB')	'oqxB'	((((((('oqxB')))))))
oxlT	('oxlT')	'oxlT'	((((((('oxlT')))))))
pa_full	('pap' & 'pas')	'pa_full'	('pap' & 'pas')
pa_partial	('pap' | 'pas')	'pa_partial'	('pap' | 'pas')
paa	('paa')	'paa'	((((((('paa')))))))
panF	('panF')	'panF'	((((((('panF')))))))
pbuE	('pbuE')	'pbuE'	((((((('pbuE')))))))
pbuG	('pbuG')	'pbuG'	((((((('pbuG')))))))
peb_full	('peb1A' & 'peb1B' & 'peb1C')	'peb_full'	('peb1A' & 'peb1B' & 'peb1C')
peb_key	('peb1A')	'peb_key'	('peb1A')
pha_full	('phaC' & 'phaF' & 'phaG' & 'phaE' & 'phaD' & 'phaA')	'pha_full'	('phaC' & 'phaF' & 'phaG' & 'phaE' & 'phaD' & 'phaA')
pha_partial	('phaC' | 'phaF' | 'phaG' | 'phaE' | 'phaD' | 'phaA')	'pha_partial'	('phaC' | 'phaF' | 'phaG' | 'phaE' | 'phaD' | 'phaA')
pheP	('pheP')	'pheP'	((((((('pheP')))))))
phn-1_full	('phnS' & 'phnV' & 'phnU' & 'phnT')	'phn-1_full'	('phnS' & 'phnV' & 'phnU' & 'phnT')
phn-1_partial	('phnS' | 'phnV' | 'phnU' | 'phnT')	'phn-1_partial'	('phnS' | 'phnV' | 'phnU' | 'phnT')
phn-2_full	('phnC' & 'phnE' & 'phnD')	'phn-2_full'	('phnC' & 'phnE' & 'phnD')
phn-2_partial	('phnC' | 'phnE' | 'phnD')	'phn-2_partial'	('phnC' | 'phnE' | 'phnD')
pho84	('PHO84')	'pho84'	('PHO84')
phoE	('phoE')	'phoE'	((((((('phoE')))))))
pit	('pit')	'pit'	((((((('pit')))))))
pro_and	('proW' & 'proV' & 'proX')	'pro_and'	('proW' & 'proV' & 'proX')
pro_key	('proX')	'pro_key'	('proX')
proP	('proP')	'proP'	((((((('proP')))))))
proY	('proY')	'proY'	((((((('proY')))))))
pslD	('pslD')	'pslD'	((((((('pslD')))))))
pst_full	('pstC' & 'pstA' & 'pstB' & 'pstS')	'pst_full'	('pstC' & 'pstA' & 'pstB' & 'pstS')
pst_partial	('pstC' | 'pstA' | 'pstB' | 'pstS')	'pst_partial'	('pstC' | 'pstA' | 'pstB' | 'pstS')
psuT	('psuT')	'psuT'	((((((('psuT')))))))
ptsIfruB_full	('ptsI' & 'fruB')	'ptsIfruB_full'	('ptsI' & 'fruB')
ptsIfruB_partial	('ptsI' | 'fruB')	'ptsIfruB_partial'	('ptsI' | 'fruB')
ptsIhpr_full	('ptsI' & 'hpr')	'ptsIhpr_full'	('ptsI' & 'hpr')
ptsIhpr_partial	('ptsI' | 'hpr')	'ptsIhpr_partial'	('ptsI' | 'hpr')
ptsIptsH_full	('ptsI' & 'ptsH')	'ptsIptsH_full'	('ptsI' & 'ptsH')
ptsIptsH_partial	('ptsI' | 'ptsH')	'ptsIptsH_partial'	('ptsI' | 'ptsH')
ptsPptsO_full	('ptsP' & 'ptsO')	'ptsPptsO_full'	('ptsP' & 'ptsO')
ptsPptsO_partial	('ptsP' | 'ptsO')	'ptsPptsO_partial'	('ptsP' | 'ptsO')
pucJ	('pucJ')	'pucJ'	((((((('pucJ')))))))
putP	('putP')	'putP'	((((((('putP')))))))
puuP	('puuP')	'puuP'	((((((('puuP')))))))
pvdE	('pvdE')	'pvdE'	((((((('pvdE')))))))
rbs_full	('rbsA' & 'rbsB' & 'rbsC')	'rbs_full'	('rbsA' & 'rbsB' & 'rbsC')
rbs_key	('rbsB')	'rbs_key'	('rbsB')
rbsU	('rbsU')	'rbsU'	((((((('rbsU')))))))
rcnA	('rcnA')	'rcnA'	((((((('rcnA')))))))
rha-1_full	('rhaP' & 'rhaQ' & 'rhaS' & 'rhaT1')	'rha-1_full'	('rhaP' & 'rhaQ' & 'rhaS' & 'rhaT1')
rha-1_key	('rhaS')	'rha-1_key'	('rhaS')
rha-2	('rhaT2')	'rha-2'	('rhaT2')
rhtA	('rhtA')	'rhtA'	((((((('rhtA')))))))
rhtB	('rhtB')	'rhtB'	((((((('rhtB')))))))
rhtC	('rhtC')	'rhtC'	((((((('rhtC')))))))
rib_full	('ribS' & 'ribP')	'rib_full'	('ribS' & 'ribP')
rib_partial	('ribS' | 'ribP')	'rib_partial'	('ribS' | 'ribP')
rocE	('rocE')	'rocE'	((((((('rocE')))))))
rutG	('rutG')	'rutG'	((((((('rutG')))))))
sam	('sam')	'sam'	((((((('sam')))))))
sap_full	('sapA' & 'sapB' & 'sapC' & 'sapD' & 'sapF')	'sap_full'	('sapA' & 'sapB' & 'sapC' & 'sapD' & 'sapF')
sap_key	('sapA')	'sap_key'	('sapA')
satP	('satP')	'satP'	((((((('satP')))))))
scr_full	('scrEIIA' & 'scrEIIB' & 'scrEIIC')	'scr_full'	('scrEIIA' & 'scrEIIB' & 'scrEIIC')
scr_partial	('scrEIIA' | 'scrEIIB' | 'scrEIIC')	'scr_partial'	('scrEIIA' | 'scrEIIB' | 'scrEIIC')
scrY	('scrY')	'scrY'	((((((('scrY')))))))
sdaC	('sdaC')	'sdaC'	((((((('sdaC')))))))
sit_full	('sitA' & 'sitB' & 'sitC' & 'sitD')	'sit_full'	('sitA' & 'sitB' & 'sitC' & 'sitD')
sit_key	('sitA')	'sit_key'	('sitA')
sme_full	('smeB' & 'smeC')	'sme_full'	('smeB' & 'smeC')
sme_partial	('smeB' | 'smeC')	'sme_partial'	('smeB' | 'smeC')
sor_full	('sorEIIA' & 'sorEIIB' & 'sorEIIC' & 'sorEIID')	'sor_full'	('sorEIIA' & 'sorEIIB' & 'sorEIIC' & 'sorEIID')
sor_partial	('sorEIIA' | 'sorEIIB' | 'sorEIIC' & 'sorEIID')	'sor_partial'	('sorEIIA' | 'sorEIIB' | 'sorEIIC' & 'sorEIID')
sotB	('sotB')	'sotB'	((((((('sotB')))))))
sstT	('sstT')	'sstT'	((((((('sstT')))))))
ssu_full	('ssuB' & 'ssuC' & 'ssuA')	'ssu_full'	('ssuB' & 'ssuC' & 'ssuA')
ssu_key	('ssuA')	'ssu_key'	('ssuA')
ste_full	('steA' & 'steB')	'ste_full'	('steA' & 'steB')
ste_partial	('steA' | 'steB')	'ste_partial'	('steA' | 'steB')
sug-1_full	('sugP' & 'sugP1' & 'sugS1')	'sug-1_full'	('sugP' & 'sugP1' & 'sugS1')
sug-1_partial	('sugP' | 'sugP1' | 'sugS1')	'sug-1_partial'	('sugP' | 'sugP1' | 'sugS1')
sug-2_full	('sugA' & 'sugP2' & 'sugS2')	'sug-2_full'	('sugA' & 'sugP2' & 'sugS2')
sug-2_partial	('sugA' | 'sugP2' | 'sugS2')	'sug-2_partial'	('sugA' | 'sugP2' | 'sugS2')
syrD	('syrD')	'syrD'	((((((('syrD')))))))
tag_full	('tagH' & 'tagG')	'tag_full'	('tagH' & 'tagG')
tag_key	('tagG')	'tag_key'	('tagG')
tau_full	('tauB' & 'tauC' & 'tauA')	'tau_full'	('tauB' & 'tauC' & 'tauA')
tau_key	('tauA')	'tau_key'	('tauA')
tc_2.A.76.1.6	('tc_2.A.76.1.6')	'tc_2.A.76.1.6'	((((((('tc_2.A.76.1.6')))))))
tc.aat	('tc.aat')	'tc.aat'	((((((('tc.aat')))))))
tc.agcs	('tc.agcs')	'tc.agcs'	((((((('tc.agcs')))))))
tc.apa	('tc.apa')	'tc.apa'	((((((('tc.apa')))))))
tc.bat2	('tc.bat2')	'tc.bat2'	((((((('tc.bat2')))))))
tc.citmhs	('tc.citmhs')	'tc.citmhs'	((((((('tc.citmhs')))))))
tc.cnt	('tc.cnt')	'tc.cnt'	((((((('tc.cnt')))))))
tc.dass	('tc.dass')	'tc.dass'	((((((('tc.dass')))))))
tc.dme	('TC.DME')	'tc.dme'	('TC.DME')
tc.fev	('tc.fev')	'tc.fev'	((((((('tc.fev')))))))
tc.gntp	('TC.GNTP')	'tc.gntp'	('TC.GNTP')
tc.gph	('tc.gph')	'tc.gph'	((((((('tc.gph')))))))
tc.hae1	('TC.HAE1')	'tc.hae1'	('TC.HAE1')
tc.livcs	('tc.livcs')	'tc.livcs'	((((((('tc.livcs')))))))
tc.ncs1	('tc.ncs1')	'tc.ncs1'	((((((('tc.ncs1')))))))
tc.ncs2	('tc.ncs2')	'tc.ncs2'	((((((('tc.ncs2')))))))
tc.nss	('tc.nss')	'tc.nss'	((((((('tc.nss')))))))
tc.pot	('tc.pot')	'tc.pot'	((((((('tc.pot')))))))
tc.sss	('tc.sss')	'tc.sss'	((((((('tc.sss')))))))
tc.sulp	('tc.sulp')	'tc.sulp'	((((((('tc.sulp')))))))
tc2.A.86.1.7	('tc2.A.86.1.7')	'tc2.A.86.1.7'	((((((('tc2.A.86.1.7')))))))
tct_full	('tctB' & 'tctC' & 'tctA')	'tct_full'	('tctB' & 'tctC' & 'tctA')
tct_partial	('tctB' | 'tctC' | 'tctA')	'tct_partial'	('tctB' | 'tctC' | 'tctA')
tcy-1_full	('tcyA' & 'tcyB' & 'tcyC')	'tcy-1_full'	('tcyA' & 'tcyB' & 'tcyC')
tcy-1_key	('tcyA')	'tcy-1_key'	('tcyA')
tcy-2_full	('tcyJ' & 'tcyK' & 'tcyL' & 'tcyM' & 'tcyN')	'tcy-2_full'	('tcyJ' & 'tcyK' & 'tcyL' & 'tcyM' & 'tcyN')
tcy-2_partial	('tcyJ' | 'tcyK')	'tcy-2_partial'	('tcyJ' | 'tcyK')
tdcC	('tdcC')	'tdcC'	((((((('tdcC')))))))
tehA	('tehA')	'tehA'	((((((('tehA')))))))
tet35	('tet35')	'tet35'	((((((('tet35')))))))
thi_full	('thiQ' & 'thiP' & 'thiB')	'thi_full'	('thiQ' & 'thiP' & 'thiB')
thi_key	('thiB')	'thi_key'	('thiB')
thiT	('thiT')	'thiT'	((((((('thiT')))))))
thu_full	('thuE' & 'thuF' & 'thuG' & 'malK')	'thu_full'	('thuE' & 'thuF' & 'thuG' & 'malK')
thu_key	('thuE')	'thu_key'	('thuE')
tnaB	('tnaB')	'tnaB'	((((((('tnaB')))))))
tog_full	('togA' & 'togM' & 'togN' & 'togB')	'tog_full'	('togA' & 'togM' & 'togN' & 'togB')
tog_key	('togB')	'tog_key'	('togB')
togT	('togT')	'togT'	((((((('togT')))))))
tol_full	('tolQ' & 'tolR')	'tol_full'	('tolQ' & 'tolR')
tol_partial	('tolQ' | 'tolR')	'tol_partial'	('tolQ' | 'tolR')
treE_full	('treEIIA' & 'treEIIB' & 'treEIIC')	'treE_full'	('treEIIA' & 'treEIIB' & 'treEIIC')
treE_partial	('treEIIA' | 'treEIIB' | 'treEIIC')	'treE_partial'	('treEIIA' | 'treEIIB' | 'treEIIC')
triC	('triC')	'triC'	((((((('triC')))))))
trkA	('trkA')	'trkA'	((((((('trkA')))))))
trkH	('trkH')	'trkH'	((((((('trkH')))))))
tro_full	('troA' & 'troB' & 'troC' & 'troD')	'tro_full'	('troA' & 'troB' & 'troC' & 'troD')
tro_key	('troA')	'tro_key'	('troA')
trp_full	('trpA' & 'trpP' & 'trpS')	'trp_full'	('trpA' & 'trpP' & 'trpS')
trp_key	('trpS')	'trp_key'	('trpS')
tsx	('tsx')	'tsx'	((((((('tsx')))))))
ttdT	('ttdT')	'ttdT'	((((((('ttdT')))))))
tuaB	('tuaB')	'tuaB'	((((((('tuaB')))))))
tup_full	('tupA' & 'tupB' & 'tupC')	'tup_full'	('tupA' & 'tupB' & 'tupC')
tup_key	('tupA')	'tup_key'	('tupA')
tutB	('tutB')	'tutB'	((((((('tutB')))))))
tyrP	('tyrP')	'tyrP'	((((((('tyrP')))))))
ugp_and	('ugpC' & 'ugpE' & 'ugpA' & 'ugpB')	'ugp_and'	('ugpC' & 'ugpE' & 'ugpA' & 'ugpB')
ugp_key	('ugpB')	'ugp_key'	('ugpB')
uhpC	('uhpC')	'uhpC'	((((((('uhpC')))))))
uid-1	('uidC')	'uid-1'	('uidC')
uid-2	('uidB')	'uid-2'	('uidB')
ula_full	('ulaEIIA' & 'ulaEIIB' & 'ulaEIIC')	'ula_full'	('ulaEIIA' & 'ulaEIIB' & 'ulaEIIC')
ula_partial	('ulaEIIA' | 'ulaEIIB' | 'ulaEIIC')	'ula_partial'	('ulaEIIA' | 'ulaEIIB' | 'ulaEIIC')
uraA	('uraA')	'uraA'	((((((('uraA')))))))
urt_full	('urtB' & 'urtD' & 'urtE' & 'urtA' & 'urtC')	'urt_full'	('urtB' & 'urtD' & 'urtE' & 'urtA' & 'urtC')
urt_key	('urtA')	'urt_key'	('urtA')
utp	('utp')	'utp'	((((((('utp')))))))
vb1x_and	('vb1xA' & 'vb1xS' & 'vb1xP')	'vb1x_and'	('vb1xA' & 'vb1xS' & 'vb1xP')
vb1x_key	('vb1xS')	'vb1x_key'	('vb1xS')
vex_full	('vexB' & 'vexD' & 'vexC')	'vex_full'	('vexB' & 'vexD' & 'vexC')
vex_key	('vexB' | 'vexD')	'vex_key'	('vexB' | 'vexD')
vexA	('vexA')	'vexA'	((((((('vexA')))))))
vexF	('vexF')	'vexF'	((((((('vexF')))))))
vpsM	('vpsM')	'vpsM'	((((((('vpsM')))))))
vpsN	('vpsN')	'vpsN'	((((((('vpsN')))))))
wtp_full	('wtpA' & 'wtpB' & 'wtpC')	'wtp_full'	('wtpA' & 'wtpB' & 'wtpC')
wtp_key	('wtpA')	'wtp_key'	('wtpA')
wza	('wza')	'wza'	((((((('wza')))))))
wzxC	('wzxC')	'wzxC'	((((((('wzxC')))))))
xanP	('xanP')	'xanP'	((((((('xanP')))))))
xanQ	('xanQ')	'xanQ'	((((((('xanQ')))))))
xapB	('xapB')	'xapB'	((((((('xapB')))))))
xlt_full	('xltA' & 'xltB' & 'xltC')	'xlt_full'	('xltA' & 'xltB' & 'xltC')
xlt_key	('xltC')	'xlt_key'	('xltC')
xyl_full	('xylF' & 'xylG' & 'xylH')	'xyl_full'	('xylF' & 'xylG' & 'xylH')
xyl_key	('xylF')	'xyl_key'	('xylF')
xylE	('xylE')	'xylE'	((((((('xylE')))))))
yad_full	('yadH' & 'yadG')	'yad_full'	('yadH' & 'yadG')
yad_partial	('yadH' | 'yadG')	'yad_partial'	('yadH' | 'yadG')
yahN	('yahN')	'yahN'	((((((('yahN')))))))
ydjE	('ydjE')	'ydjE'	((((((('ydjE')))))))
yia_full	('yiaN' & 'yiaM' & 'yiaO')	'yia_full'	('yiaN' & 'yiaM' & 'yiaO')
yia_partial	('yiaN' | 'yiaM' | 'yiaO')	'yia_partial'	('yiaN' | 'yiaM' | 'yiaO')
yjbB	('yjbB')	'yjbB'	((((((('yjbB')))))))
yjeH	('yjeH')	'yjeH'	((((((('yjeH')))))))
ykk_full	('ykkC' & 'ykkD')	'ykk_full'	('ykkC' & 'ykkD')
ykk_partial	('ykkC' | 'ykkD')	'ykk_partial'	('ykkC' | 'ykkD')
ylnA	('ylnA')	'ylnA'	((((((('ylnA')))))))
ynfM	('ynfM')	'ynfM'	((((((('ynfM')))))))
yojI	('yojI')	'yojI'	((((((('yojI')))))))
yqgE	('yqgE')	'yqgE'	((((((('yqgE')))))))
yrbG	('yrbG')	'yrbG'	((((((('yrbG')))))))
ytr_full	('ytrB' & 'ytrE' & 'ytrF' & 'ytrC_D')	'ytr_full'	('ytrB' & 'ytrE' & 'ytrF' & 'ytrC_D')
ytr_partial	('ytrB' | 'ytrE' | 'ytrF' | 'ytrC_D')	'ytr_partial'	('ytrB' | 'ytrE' | 'ytrF' | 'ytrC_D')
yuiF	('yuiF')	'yuiF'	((((((('yuiF')))))))
yxjA	('yxjA')	'yxjA'	((((((('yxjA')))))))
yyd_full	('yydI' & 'yydJ')	'yyd_full'	('yydI' & 'yydJ')
yyd_partial	('yydI' | 'yydJ')	'yyd_partial'	('yydI' | 'yydJ')
zipB	('zipB')	'zipB'	((((((('zipB')))))))
zm_full	('zmA' & 'zmP' & 'zmS')	'zm_full'	('zmA' & 'zmP' & 'zmS')
zm_key	('zmS')	'zm_key'	('zmS')
zntB	('zntB')	'zntB'	((((((('zntB')))))))
znu_full	('znuA' & 'znuB' & 'znuC')	'znu_full'	('znuA' & 'znuB' & 'znuC')
znu_key	('znuA')	'znu_key'	('znuA')
pyruvate->SCFAs	(('pyruvate->butanoate') | ('propionate fermentation_succinatepathway') | ('pyruvate->acetate'))	'pyruvate->SCFAs'	((((('pflD')) & (('buk')))) | (((('mut')) & (('epi')) & (('tdcD' | 'pduW')))) | ((('poxB') | (((('pta1' | 'pta2' | 'pta3')) & (('ackA')))))))
pyruvate->lactate and ethanol	(('pyruvate->lactate') & ('acetaldehyde->ethanol'))	'pyruvate->lactate and ethanol'	((('ldh')) & (('adh' | 'adhP' | 'adhE' | 'exaA' | 'yiaY')))
pyruvate->alcohols	(('pyruvate->ethanol') | ('pyruvate->butyleneglycol') | ('acetone->isopropanol') | ('pyruvate->butanol'))	'pyruvate->alcohols'	((((('pdc')) & (('adh' | 'adhP' | 'adhE' | 'exaA' | 'yiaY')))) | (((('aclSlarge' | 'aclSsmall_1' | 'aclSsmall_2')) & (('alsD')) & (('butB')))) | (('isopadh')) | (((('pflD')) & (('bdhAB')))))
acetyl-CoA->acetate	(('acetyl-CoA->acetyl-P') & ('acetyl-P<->acetate'))	'acetyl-CoA->acetate'	((('pta1' | 'pta2' | 'pta3')) & (('ackA')))
nuo_and	('nuoA' & 'nuoB' & 'nuoC' & 'nuoD' & 'nuoE' & 'nuoF' & 'nuoG' & 'nuoH' & 'nuoI' & 'nuoJ' & 'nuoK' & 'nuoL' & 'nuoM' & 'nuoN')	'nuo_and'	('nuoA' & 'nuoB' & 'nuoC' & 'nuoD' & 'nuoE' & 'nuoF' & 'nuoG' & 'nuoH' & 'nuoI' & 'nuoJ' & 'nuoK' & 'nuoL' & 'nuoM' & 'nuoN')
nuo_or	('nuoA' | 'nuoB' | 'nuoBCD' | 'nuoC' | 'nuoCD' | 'nuoD' | 'nuoE' | 'nuoF' | 'nuoG' | 'nuoH' | 'nuoI' | 'nuoJ' | 'nuoK' | 'nuoL' | 'nuoLM' | 'nuoM' | 'nuoN')	'nuo_or'	('nuoA' | 'nuoB' | 'nuoBCD' | 'nuoC' | 'nuoCD' | 'nuoD' | 'nuoE' | 'nuoF' | 'nuoG' | 'nuoH' | 'nuoI' | 'nuoJ' | 'nuoK' | 'nuoL' | 'nuoLM' | 'nuoM' | 'nuoN')
ETC_complexI	('nuo_and')	'ETC_complexI'	(('nuoA' & 'nuoB' & 'nuoC' & 'nuoD' & 'nuoE' & 'nuoF' & 'nuoG' & 'nuoH' & 'nuoI' & 'nuoJ' & 'nuoK' & 'nuoL' & 'nuoM' & 'nuoN'))
ETC_complexII	('succinate->fumarate_key')	'ETC_complexII'	((('sdhA' & 'sdhB' & 'sdhC') | ('frdA' & 'frdB' & 'frdC')))
cytochromecreductase_or	('qcrA' | 'fbcH' | 'petB_2' | 'petB_1' | 'qcrB')	'cytochromecreductase_or'	('qcrA' | 'fbcH' | 'petB_2' | 'petB_1' | 'qcrB')
ETC_complexIII	('cytochromecreductase_or')	'ETC_complexIII'	(('qcrA' | 'fbcH' | 'petB_2' | 'petB_1' | 'qcrB'))
cytochromeoubiquinol_and	('cyoA' & 'cyoB' & 'cyoC')	'cytochromeoubiquinol_and'	('cyoA' & 'cyoB' & 'cyoC')
cytochromec_and	('coxA' & 'coxB' & 'coxC')	'cytochromec_and'	('coxA' & 'coxB' & 'coxC')
cytochromeaa3600menaquinol_and	('qoxA' & 'qoxB' & 'qoxC')	'cytochromeaa3600menaquinol_and'	('qoxA' & 'qoxB' & 'qoxC')
cytochromeccbb3oxidase_and	('ccoN' & 'ccoO' & 'ccoP')	'cytochromeccbb3oxidase_and'	('ccoN' & 'ccoO' & 'ccoP')
ETC_complexIV	(('cytochromeoubiquinol_and') | ('cytochromec_and') | ('cytochromeaa3600menaquinol_and' | 'cytochromeccbb3oxidase_and'))	'ETC_complexIV'	((('cyoA' & 'cyoB' & 'cyoC')) | (('coxA' & 'coxB' & 'coxC')) | (('qoxA' & 'qoxB' & 'qoxC') | ('ccoN' & 'ccoO' & 'ccoP')))
cytochromebd_and	('cydA' & 'cydB')	'cytochromebd_and'	('cydA' & 'cydB')
ATPaseFtype_and	('atpA' & 'atpB' & 'atpC' & 'atpD' & 'atpE' & 'atpF' & 'atpG' & 'atpH')	'ATPaseFtype_and'	('atpA' & 'atpB' & 'atpC' & 'atpD' & 'atpE' & 'atpF' & 'atpG' & 'atpH')
ATPaseVAtype_and	('atpvaA' & 'atpvaB' & 'atpvaC' & 'atpvaD' & 'atpvaE' & 'atpvaF' & 'atpvaGH')	'ATPaseVAtype_and'	('atpvaA' & 'atpvaB' & 'atpvaC' & 'atpvaD' & 'atpvaE' & 'atpvaF' & 'atpvaGH')
ndh_and	('ndhA' & 'ndhB' & 'ndhC' & 'ndhD' & 'ndhE' & 'ndhF' & 'ndhG' & 'ndhH' & 'ndhI' & 'ndhJ' & 'ndhK' & 'ndhL' & 'ndhM' & 'ndhN')	'ndh_and'	('ndhA' & 'ndhB' & 'ndhC' & 'ndhD' & 'ndhE' & 'ndhF' & 'ndhG' & 'ndhH' & 'ndhI' & 'ndhJ' & 'ndhK' & 'ndhL' & 'ndhM' & 'ndhN')
ndh_or	('ndhA' | 'ndhB' | 'ndhC' | 'ndhD' | 'ndhE' | 'ndhF' | 'ndhG' | 'ndhH' | 'ndhI' | 'ndhJ' | 'ndhK' | 'ndhL' | 'ndhM' | 'ndhN')	'ndh_or'	('ndhA' | 'ndhB' | 'ndhC' | 'ndhD' | 'ndhE' | 'ndhF' | 'ndhG' | 'ndhH' | 'ndhI' | 'ndhJ' | 'ndhK' | 'ndhL' | 'ndhM' | 'ndhN')
hox_and	('hoxE' & 'hoxF_1' & 'hoxU_1')	'hox_and'	('hoxE' & 'hoxF_1' & 'hoxU_1')
hox_or	('hoxE' | 'hoxF_1' | 'hoxU_1')	'hox_or'	('hoxE' | 'hoxF_1' | 'hoxU_1')
qmo_and	('qmoA' & 'qmoB' & 'qmoC')	'qmo_and'	('qmoA' & 'qmoB' & 'qmoC')
qmo_or	('qmoA' | 'qmoB' | 'qmoC')	'qmo_or'	('qmoA' | 'qmoB' | 'qmoC')
fpo_and	('fpoA' & 'fpoB' & 'fpoC' & 'fpoD' & 'fpoF' & 'fpoH' & 'fpoI' & 'fpoJ' & 'fpoK' & 'fpoL' & 'fpoM' & 'fpoN' & 'fpoO')	'fpo_and'	('fpoA' & 'fpoB' & 'fpoC' & 'fpoD' & 'fpoF' & 'fpoH' & 'fpoI' & 'fpoJ' & 'fpoK' & 'fpoL' & 'fpoM' & 'fpoN' & 'fpoO')
fpo_or	('fpoA' | 'fpoB' | 'fpoC' | 'fpoD' | 'fpoF' | 'fpoH' | 'fpoI' | 'fpoJ' & 'fpoK' | 'fpoL' | 'fpoM' | 'fpoN' | 'fpoO')	'fpo_or'	('fpoA' | 'fpoB' | 'fpoC' | 'fpoD' | 'fpoF' | 'fpoH' | 'fpoI' | 'fpoJ' & 'fpoK' | 'fpoL' | 'fpoM' | 'fpoN' | 'fpoO')
ech_and	('echA' & 'echB' & 'echC' & 'echD' & 'echE' & 'echF')	'ech_and'	('echA' & 'echB' & 'echC' & 'echD' & 'echE' & 'echF')
ech_or	('echA' | 'echB' | 'echC' | 'echD' | 'echE' | 'echF')	'ech_or'	('echA' | 'echB' | 'echC' | 'echD' | 'echE' | 'echF')
vht_and	('vhtA' & 'vhtC' & 'vhtG')	'vht_and'	('vhtA' & 'vhtC' & 'vhtG')
vht_or	('vhtA' | 'vhtC' | 'vhtG')	'vht_or'	('vhtA' | 'vhtC' | 'vhtG')
nqr_and	('nqrA' & 'nqrB' & 'nqrC' & 'nqrD' & 'nqrE' & 'nqrF')	'nqr_and'	('nqrA' & 'nqrB' & 'nqrC' & 'nqrD' & 'nqrE' & 'nqrF')
nqr_or	('nqrA' | 'nqrB' | 'nqrC' | 'nqrD' | 'nqrE' | 'nqrF')	'nqr_or'	('nqrA' | 'nqrB' | 'nqrC' | 'nqrD' | 'nqrE' | 'nqrF')
hyd_and	('hydA_1' & 'hydD' & 'hydG' & 'hydB_1')	'hyd_and'	('hydA_1' & 'hydD' & 'hydG' & 'hydB_1')
hyd_or	('hydA_1' | 'hydD' | 'hydG' | 'hydB_1')	'hyd_or'	('hydA_1' | 'hydD' | 'hydG' | 'hydB_1')
rnf_and	('rnfA' & 'rnfB' & 'rnfC' & 'rnfD' & 'rnfE' & 'rnfG')	'rnf_and'	('rnfA' & 'rnfB' & 'rnfC' & 'rnfD' & 'rnfE' & 'rnfG')
rnf_or	('rnfA' | 'rnfB' | 'rnfC' | 'rnfD' | 'rnfE' | 'rnfG')	'rnf_or'	('rnfA' | 'rnfB' | 'rnfC' | 'rnfD' | 'rnfE' | 'rnfG')
bacteriochlorophyll g synthesis	('bchX' | 'bchY' | 'bchZ')	'bacteriochlorophyll g synthesis'	('bchX' | 'bchY' | 'bchZ')
